Club,Matches Played,Wins,Draws,Losses,Goals Scored,Goals Against,Pts,League,Season
Man Utd,42,24,12,6,67,31,36,premierleague,1992
Aston Villa,42,21,11,10,57,40,17,premierleague,1992
Norwich,42,21,9,12,61,65,-4,premierleague,1992
Blackburn,42,20,11,11,68,46,22,premierleague,1992
QPR,42,17,12,13,63,55,8,premierleague,1992
Liverpool,42,16,11,15,62,55,7,premierleague,1992
Sheff Wed,42,15,14,13,55,51,4,premierleague,1992
Tottenham,42,16,11,15,60,66,-6,premierleague,1992
Man City,42,15,12,15,56,51,5,premierleague,1992
Arsenal,42,15,11,16,40,38,2,premierleague,1992
Chelsea,42,14,14,14,51,54,-3,premierleague,1992
Wimbledon FC,42,14,12,16,56,55,1,premierleague,1992
Everton,42,15,8,19,53,55,-2,premierleague,1992
Sheff Utd,42,14,10,18,54,53,1,premierleague,1992
Coventry,42,13,13,16,52,57,-5,premierleague,1992
Ipswich,42,12,16,14,50,55,-5,premierleague,1992
Leeds,42,12,15,15,57,62,-5,premierleague,1992
Southampton,42,13,11,18,54,61,-7,premierleague,1992
Oldham Athletic,42,13,10,19,63,74,-11,premierleague,1992
Crystal Palace,42,11,16,15,48,61,-13,premierleague,1992
Middlesbrough,42,11,11,20,54,75,-21,premierleague,1992
Nottm Forest,42,10,10,22,41,62,-21,premierleague,1992
Man Utd,42,27,11,4,80,38,42,premierleague,1993
Blackburn,42,25,9,8,63,36,27,premierleague,1993
Newcastle,42,23,8,11,82,41,41,premierleague,1993
Arsenal,42,18,17,7,53,28,25,premierleague,1993
Leeds,42,18,16,8,65,39,26,premierleague,1993
Wimbledon FC,42,18,11,13,56,53,3,premierleague,1993
Sheff Wed,42,16,16,10,76,54,22,premierleague,1993
Liverpool,42,17,9,16,59,55,4,premierleague,1993
QPR,42,16,12,14,62,61,1,premierleague,1993
Aston Villa,42,15,12,15,46,50,-4,premierleague,1993
Coventry,42,14,14,14,43,45,-2,premierleague,1993
Norwich,42,12,17,13,65,61,4,premierleague,1993
West Ham,42,13,13,16,47,58,-11,premierleague,1993
Chelsea,42,13,12,17,49,53,-4,premierleague,1993
Tottenham,42,11,12,19,54,59,-5,premierleague,1993
Man City,42,9,18,15,38,49,-11,premierleague,1993
Everton,42,12,8,22,42,63,-21,premierleague,1993
Southampton,42,12,7,23,49,66,-17,premierleague,1993
Ipswich,42,9,16,17,35,58,-23,premierleague,1993
Sheff Utd,42,8,18,16,42,60,-18,premierleague,1993
Oldham Athletic,42,9,13,20,42,68,-26,premierleague,1993
Swindon Town,42,5,15,22,47,100,-53,premierleague,1993
Blackburn,42,27,8,7,80,39,41,premierleague,1994
Man Utd,42,26,10,6,77,28,49,premierleague,1994
Nottm Forest,42,22,11,9,72,43,29,premierleague,1994
Liverpool,42,21,11,10,65,37,28,premierleague,1994
Leeds,42,20,13,9,59,38,21,premierleague,1994
Newcastle,42,20,12,10,67,47,20,premierleague,1994
Tottenham,42,16,14,12,66,58,8,premierleague,1994
QPR,42,17,9,16,61,59,2,premierleague,1994
Wimbledon FC,42,15,11,16,48,65,-17,premierleague,1994
Southampton,42,12,18,12,61,63,-2,premierleague,1994
Chelsea,42,13,15,14,50,55,-5,premierleague,1994
Arsenal,42,13,12,17,52,49,3,premierleague,1994
Sheff Wed,42,13,12,17,49,57,-8,premierleague,1994
West Ham,42,13,11,18,44,48,-4,premierleague,1994
Everton,42,11,17,14,44,51,-7,premierleague,1994
Coventry,42,12,14,16,44,62,-18,premierleague,1994
Man City,42,12,13,17,53,64,-11,premierleague,1994
Aston Villa,42,11,15,16,51,56,-5,premierleague,1994
Crystal Palace,42,11,12,19,34,49,-15,premierleague,1994
Norwich,42,10,13,19,37,54,-17,premierleague,1994
Leicester,42,6,11,25,45,80,-35,premierleague,1994
Ipswich,42,7,6,29,36,93,-57,premierleague,1994
Man Utd,38,25,7,6,73,35,38,premierleague,1995
Newcastle,38,24,6,8,66,37,29,premierleague,1995
Liverpool,38,20,11,7,70,34,36,premierleague,1995
Aston Villa,38,18,9,11,52,35,17,premierleague,1995
Arsenal,38,17,12,9,49,32,17,premierleague,1995
Everton,38,17,10,11,64,44,20,premierleague,1995
Blackburn,38,18,7,13,61,47,14,premierleague,1995
Tottenham,38,16,13,9,50,38,12,premierleague,1995
Nottm Forest,38,15,13,10,50,54,-4,premierleague,1995
West Ham,38,14,9,15,43,52,-9,premierleague,1995
Chelsea,38,12,14,12,46,44,2,premierleague,1995
Middlesbrough,38,11,10,17,35,50,-15,premierleague,1995
Leeds,38,12,7,19,40,57,-17,premierleague,1995
Wimbledon FC,38,10,11,17,55,70,-15,premierleague,1995
Sheff Wed,38,10,10,18,48,61,-13,premierleague,1995
Coventry,38,8,14,16,42,60,-18,premierleague,1995
Southampton,38,9,11,18,34,52,-18,premierleague,1995
Man City,38,9,11,18,33,58,-25,premierleague,1995
QPR,38,9,6,23,38,57,-19,premierleague,1995
Bolton,38,8,5,25,39,71,-32,premierleague,1995
Man Utd,38,21,12,5,76,44,32,premierleague,1996
Newcastle,38,19,11,8,73,40,33,premierleague,1996
Arsenal,38,19,11,8,62,32,30,premierleague,1996
Liverpool,38,19,11,8,62,37,25,premierleague,1996
Aston Villa,38,17,10,11,47,34,13,premierleague,1996
Chelsea,38,16,11,11,58,55,3,premierleague,1996
Sheff Wed,38,14,15,9,50,51,-1,premierleague,1996
Wimbledon FC,38,15,11,12,49,46,3,premierleague,1996
Leicester,38,12,11,15,46,54,-8,premierleague,1996
Tottenham,38,13,7,18,44,51,-7,premierleague,1996
Leeds,38,11,13,14,28,38,-10,premierleague,1996
Derby,38,11,13,14,45,58,-13,premierleague,1996
Blackburn,38,9,15,14,42,43,-1,premierleague,1996
West Ham,38,10,12,16,39,48,-9,premierleague,1996
Everton,38,10,12,16,44,57,-13,premierleague,1996
Southampton,38,10,11,17,50,56,-6,premierleague,1996
Coventry,38,9,14,15,38,54,-16,premierleague,1996
Sunderland,38,10,10,18,35,53,-18,premierleague,1996
Middlesbrough,38,10,12,16,51,60,-9,premierleague,1996
Nottm Forest,38,6,16,16,31,59,-28,premierleague,1996
Arsenal,38,23,9,6,68,33,35,premierleague,1997
Man Utd,38,23,8,7,73,26,47,premierleague,1997
Liverpool,38,18,11,9,68,42,26,premierleague,1997
Chelsea,38,20,3,15,71,43,28,premierleague,1997
Leeds,38,17,8,13,57,46,11,premierleague,1997
Blackburn,38,16,10,12,57,52,5,premierleague,1997
Aston Villa,38,17,6,15,49,48,1,premierleague,1997
West Ham,38,16,8,14,56,57,-1,premierleague,1997
Derby,38,16,7,15,52,49,3,premierleague,1997
Leicester,38,13,14,11,51,41,10,premierleague,1997
Coventry,38,12,16,10,46,44,2,premierleague,1997
Southampton,38,14,6,18,50,55,-5,premierleague,1997
Newcastle,38,11,11,16,35,44,-9,premierleague,1997
Tottenham,38,11,11,16,44,56,-12,premierleague,1997
Wimbledon FC,38,10,14,14,34,46,-12,premierleague,1997
Sheff Wed,38,12,8,18,52,67,-15,premierleague,1997
Everton,38,9,13,16,41,56,-15,premierleague,1997
Bolton,38,9,13,16,41,61,-20,premierleague,1997
Barnsley,38,10,5,23,37,82,-45,premierleague,1997
Crystal Palace,38,8,9,21,37,71,-34,premierleague,1997
Man Utd,38,22,13,3,80,37,43,premierleague,1998
Arsenal,38,22,12,4,59,17,42,premierleague,1998
Chelsea,38,20,15,3,57,30,27,premierleague,1998
Leeds,38,18,13,7,62,34,28,premierleague,1998
West Ham,38,16,9,13,46,53,-7,premierleague,1998
Aston Villa,38,15,10,13,51,46,5,premierleague,1998
Liverpool,38,15,9,14,68,49,19,premierleague,1998
Derby,38,13,13,12,40,45,-5,premierleague,1998
Middlesbrough,38,12,15,11,48,54,-6,premierleague,1998
Leicester,38,12,13,13,40,46,-6,premierleague,1998
Tottenham,38,11,14,13,47,50,-3,premierleague,1998
Sheff Wed,38,13,7,18,41,42,-1,premierleague,1998
Newcastle,38,11,13,14,48,54,-6,premierleague,1998
Everton,38,11,10,17,42,47,-5,premierleague,1998
Coventry,38,11,9,18,39,51,-12,premierleague,1998
Wimbledon FC,38,10,12,16,40,63,-23,premierleague,1998
Southampton,38,11,8,19,37,64,-27,premierleague,1998
Charlton,38,8,12,18,41,56,-15,premierleague,1998
Blackburn,38,7,14,17,38,52,-14,premierleague,1998
Nottm Forest,38,7,9,22,35,69,-34,premierleague,1998
Man Utd,38,28,7,3,97,45,52,premierleague,1999
Arsenal,38,22,7,9,73,43,30,premierleague,1999
Leeds,38,21,6,11,58,43,15,premierleague,1999
Liverpool,38,19,10,9,51,30,21,premierleague,1999
Chelsea,38,18,11,9,53,34,19,premierleague,1999
Aston Villa,38,15,13,10,46,35,11,premierleague,1999
Sunderland,38,16,10,12,57,56,1,premierleague,1999
Leicester,38,16,7,15,55,55,0,premierleague,1999
West Ham,38,15,10,13,52,53,-1,premierleague,1999
Tottenham,38,15,8,15,57,49,8,premierleague,1999
Newcastle,38,14,10,14,63,54,9,premierleague,1999
Middlesbrough,38,14,10,14,46,52,-6,premierleague,1999
Everton,38,12,14,12,59,49,10,premierleague,1999
Coventry,38,12,8,18,47,54,-7,premierleague,1999
Southampton,38,12,8,18,45,62,-17,premierleague,1999
Derby,38,9,11,18,44,57,-13,premierleague,1999
Bradford,38,9,9,20,38,68,-30,premierleague,1999
Wimbledon FC,38,7,12,19,46,74,-28,premierleague,1999
Sheff Wed,38,8,7,23,38,70,-32,premierleague,1999
Watford,38,6,6,26,35,77,-42,premierleague,1999
Man Utd,38,24,8,6,79,31,48,premierleague,2000
Arsenal,38,20,10,8,63,38,25,premierleague,2000
Liverpool,38,20,9,9,71,39,32,premierleague,2000
Leeds,38,20,8,10,64,43,21,premierleague,2000
Ipswich,38,20,6,12,57,42,15,premierleague,2000
Chelsea,38,17,10,11,68,45,23,premierleague,2000
Sunderland,38,15,12,11,46,41,5,premierleague,2000
Aston Villa,38,13,15,10,46,43,3,premierleague,2000
Charlton,38,14,10,14,50,57,-7,premierleague,2000
Southampton,38,14,10,14,40,48,-8,premierleague,2000
Newcastle,38,14,9,15,44,50,-6,premierleague,2000
Tottenham,38,13,10,15,47,54,-7,premierleague,2000
Leicester,38,14,6,18,39,51,-12,premierleague,2000
Middlesbrough,38,9,15,14,44,44,0,premierleague,2000
West Ham,38,10,12,16,45,50,-5,premierleague,2000
Everton,38,11,9,18,45,59,-14,premierleague,2000
Derby,38,10,12,16,37,59,-22,premierleague,2000
Man City,38,8,10,20,41,65,-24,premierleague,2000
Coventry,38,8,10,20,36,63,-27,premierleague,2000
Bradford,38,5,11,22,30,70,-40,premierleague,2000
Arsenal,38,26,9,3,79,36,43,premierleague,2001
Liverpool,38,24,8,6,67,30,37,premierleague,2001
Man Utd,38,24,5,9,87,45,42,premierleague,2001
Newcastle,38,21,8,9,74,52,22,premierleague,2001
Leeds,38,18,12,8,53,37,16,premierleague,2001
Chelsea,38,17,13,8,66,38,28,premierleague,2001
West Ham,38,15,8,15,48,57,-9,premierleague,2001
Aston Villa,38,12,14,12,46,47,-1,premierleague,2001
Tottenham,38,14,8,16,49,53,-4,premierleague,2001
Blackburn,38,12,10,16,55,51,4,premierleague,2001
Southampton,38,12,9,17,46,54,-8,premierleague,2001
Middlesbrough,38,12,9,17,35,47,-12,premierleague,2001
Fulham,38,10,14,14,36,44,-8,premierleague,2001
Charlton,38,10,14,14,38,49,-11,premierleague,2001
Everton,38,11,10,17,45,57,-12,premierleague,2001
Bolton,38,9,13,16,44,62,-18,premierleague,2001
Sunderland,38,10,10,18,29,51,-22,premierleague,2001
Ipswich,38,9,9,20,41,64,-23,premierleague,2001
Derby,38,8,6,24,33,63,-30,premierleague,2001
Leicester,38,5,13,20,30,64,-34,premierleague,2001
Man Utd,38,25,8,5,74,34,40,premierleague,2002
Arsenal,38,23,9,6,85,42,43,premierleague,2002
Newcastle,38,21,6,11,63,48,15,premierleague,2002
Chelsea,38,19,10,9,68,38,30,premierleague,2002
Liverpool,38,18,10,10,61,41,20,premierleague,2002
Blackburn,38,16,12,10,52,43,9,premierleague,2002
Everton,38,17,8,13,48,49,-1,premierleague,2002
Southampton,38,13,13,12,43,46,-3,premierleague,2002
Man City,38,15,6,17,47,54,-7,premierleague,2002
Tottenham,38,14,8,16,51,62,-11,premierleague,2002
Middlesbrough,38,13,10,15,48,44,4,premierleague,2002
Charlton,38,14,7,17,45,56,-11,premierleague,2002
Birmingham,38,13,9,16,41,49,-8,premierleague,2002
Fulham,38,13,9,16,41,50,-9,premierleague,2002
Leeds,38,14,5,19,58,57,1,premierleague,2002
Aston Villa,38,12,9,17,42,47,-5,premierleague,2002
Bolton,38,10,14,14,41,51,-10,premierleague,2002
West Ham,38,10,12,16,42,59,-17,premierleague,2002
West Brom,38,6,8,24,29,65,-36,premierleague,2002
Sunderland,38,4,7,27,21,65,-44,premierleague,2002
Arsenal,38,26,12,0,73,26,47,premierleague,2003
Chelsea,38,24,7,7,67,30,37,premierleague,2003
Man Utd,38,23,6,9,64,35,29,premierleague,2003
Liverpool,38,16,12,10,55,37,18,premierleague,2003
Newcastle,38,13,17,8,52,40,12,premierleague,2003
Aston Villa,38,15,11,12,48,44,4,premierleague,2003
Charlton,38,14,11,13,51,51,0,premierleague,2003
Bolton,38,14,11,13,48,56,-8,premierleague,2003
Fulham,38,14,10,14,52,46,6,premierleague,2003
Birmingham,38,12,14,12,43,48,-5,premierleague,2003
Middlesbrough,38,13,9,16,44,52,-8,premierleague,2003
Southampton,38,12,11,15,44,45,-1,premierleague,2003
Portsmouth,38,12,9,17,47,54,-7,premierleague,2003
Tottenham,38,13,6,19,47,57,-10,premierleague,2003
Blackburn,38,12,8,18,51,59,-8,premierleague,2003
Man City,38,9,14,15,55,54,1,premierleague,2003
Everton,38,9,12,17,45,57,-12,premierleague,2003
Leicester,38,6,15,17,48,65,-17,premierleague,2003
Leeds,38,8,9,21,40,79,-39,premierleague,2003
Wolves,38,7,12,19,38,77,-39,premierleague,2003
Chelsea,38,29,8,1,72,15,57,premierleague,2004
Arsenal,38,25,8,5,87,36,51,premierleague,2004
Man Utd,38,22,11,5,58,26,32,premierleague,2004
Everton,38,18,7,13,45,46,-1,premierleague,2004
Liverpool,38,17,7,14,52,41,11,premierleague,2004
Bolton,38,16,10,12,49,44,5,premierleague,2004
Middlesbrough,38,14,13,11,53,46,7,premierleague,2004
Man City,38,13,13,12,47,39,8,premierleague,2004
Tottenham,38,14,10,14,47,41,6,premierleague,2004
Aston Villa,38,12,11,15,45,52,-7,premierleague,2004
Charlton,38,12,10,16,42,58,-16,premierleague,2004
Birmingham,38,11,12,15,40,46,-6,premierleague,2004
Fulham,38,12,8,18,52,60,-8,premierleague,2004
Newcastle,38,10,14,14,47,57,-10,premierleague,2004
Blackburn,38,9,15,14,32,43,-11,premierleague,2004
Portsmouth,38,10,9,19,43,59,-16,premierleague,2004
West Brom,38,6,16,16,36,61,-25,premierleague,2004
Crystal Palace,38,7,12,19,41,62,-21,premierleague,2004
Norwich,38,7,12,19,42,77,-35,premierleague,2004
Southampton,38,6,14,18,45,66,-21,premierleague,2004
Chelsea,38,29,4,5,72,22,50,premierleague,2005
Man Utd,38,25,8,5,72,34,38,premierleague,2005
Liverpool,38,25,7,6,57,25,32,premierleague,2005
Arsenal,38,20,7,11,68,31,37,premierleague,2005
Tottenham,38,18,11,9,53,38,15,premierleague,2005
Blackburn,38,19,6,13,51,42,9,premierleague,2005
Newcastle,38,17,7,14,47,42,5,premierleague,2005
Bolton,38,15,11,12,49,41,8,premierleague,2005
West Ham,38,16,7,15,52,55,-3,premierleague,2005
Wigan,38,15,6,17,45,52,-7,premierleague,2005
Everton,38,14,8,16,34,49,-15,premierleague,2005
Fulham,38,14,6,18,48,58,-10,premierleague,2005
Charlton,38,13,8,17,41,55,-14,premierleague,2005
Middlesbrough,38,12,9,17,48,58,-10,premierleague,2005
Man City,38,13,4,21,43,48,-5,premierleague,2005
Aston Villa,38,10,12,16,42,55,-13,premierleague,2005
Portsmouth,38,10,8,20,37,62,-25,premierleague,2005
Birmingham,38,8,10,20,28,50,-22,premierleague,2005
West Brom,38,7,9,22,31,58,-27,premierleague,2005
Sunderland,38,3,6,29,26,69,-43,premierleague,2005
Man Utd,38,28,5,5,83,27,56,premierleague,2006
Chelsea,38,24,11,3,64,24,40,premierleague,2006
Liverpool,38,20,8,10,57,27,30,premierleague,2006
Arsenal,38,19,11,8,63,35,28,premierleague,2006
Tottenham,38,17,9,12,57,54,3,premierleague,2006
Everton,38,15,13,10,52,36,16,premierleague,2006
Bolton,38,16,8,14,47,52,-5,premierleague,2006
Reading,38,16,7,15,52,47,5,premierleague,2006
Portsmouth,38,14,12,12,45,42,3,premierleague,2006
Blackburn,38,15,7,16,52,54,-2,premierleague,2006
Aston Villa,38,11,17,10,43,41,2,premierleague,2006
Middlesbrough,38,12,10,16,44,49,-5,premierleague,2006
Newcastle,38,11,10,17,38,47,-9,premierleague,2006
Man City,38,11,9,18,29,44,-15,premierleague,2006
West Ham,38,12,5,21,35,59,-24,premierleague,2006
Fulham,38,8,15,15,38,60,-22,premierleague,2006
Wigan,38,10,8,20,37,59,-22,premierleague,2006
Sheff Utd,38,10,8,20,32,55,-23,premierleague,2006
Charlton,38,8,10,20,34,60,-26,premierleague,2006
Watford,38,5,13,20,29,59,-30,premierleague,2006
Man Utd,38,27,6,5,80,22,58,premierleague,2007
Chelsea,38,25,10,3,65,26,39,premierleague,2007
Arsenal,38,24,11,3,74,31,43,premierleague,2007
Liverpool,38,21,13,4,67,28,39,premierleague,2007
Everton,38,19,8,11,55,33,22,premierleague,2007
Aston Villa,38,16,12,10,71,51,20,premierleague,2007
Blackburn,38,15,13,10,50,48,2,premierleague,2007
Portsmouth,38,16,9,13,48,40,8,premierleague,2007
Man City,38,15,10,13,45,53,-8,premierleague,2007
West Ham,38,13,10,15,42,50,-8,premierleague,2007
Tottenham,38,11,13,14,66,61,5,premierleague,2007
Newcastle,38,11,10,17,45,65,-20,premierleague,2007
Middlesbrough,38,10,12,16,43,53,-10,premierleague,2007
Wigan,38,10,10,18,34,51,-17,premierleague,2007
Sunderland,38,11,6,21,36,59,-23,premierleague,2007
Bolton,38,9,10,19,36,54,-18,premierleague,2007
Fulham,38,8,12,18,38,60,-22,premierleague,2007
Reading,38,10,6,22,41,66,-25,premierleague,2007
Birmingham,38,8,11,19,46,62,-16,premierleague,2007
Derby,38,1,8,29,20,89,-69,premierleague,2007
Man Utd,38,28,6,4,68,24,44,premierleague,2008
Liverpool,38,25,11,2,77,27,50,premierleague,2008
Chelsea,38,25,8,5,68,24,44,premierleague,2008
Arsenal,38,20,12,6,68,37,31,premierleague,2008
Everton,38,17,12,9,55,37,18,premierleague,2008
Aston Villa,38,17,11,10,54,48,6,premierleague,2008
Fulham,38,14,11,13,39,34,5,premierleague,2008
Tottenham,38,14,9,15,45,45,0,premierleague,2008
West Ham,38,14,9,15,42,45,-3,premierleague,2008
Man City,38,15,5,18,58,50,8,premierleague,2008
Wigan,38,12,9,17,34,45,-11,premierleague,2008
Stoke City,38,12,9,17,38,55,-17,premierleague,2008
Bolton,38,11,8,19,41,53,-12,premierleague,2008
Portsmouth,38,10,11,17,38,57,-19,premierleague,2008
Blackburn,38,10,11,17,40,60,-20,premierleague,2008
Sunderland,38,9,9,20,34,54,-20,premierleague,2008
Hull City,38,8,11,19,39,64,-25,premierleague,2008
Newcastle,38,7,13,18,40,59,-19,premierleague,2008
Middlesbrough,38,7,11,20,28,57,-29,premierleague,2008
West Brom,38,8,8,22,36,67,-31,premierleague,2008
Chelsea,38,27,5,6,103,32,71,premierleague,2009
Man Utd,38,27,4,7,86,28,58,premierleague,2009
Arsenal,38,23,6,9,83,41,42,premierleague,2009
Tottenham,38,21,7,10,67,41,26,premierleague,2009
Man City,38,18,13,7,73,45,28,premierleague,2009
Aston Villa,38,17,13,8,52,39,13,premierleague,2009
Liverpool,38,18,9,11,61,35,26,premierleague,2009
Everton,38,16,13,9,60,49,11,premierleague,2009
Birmingham,38,13,11,14,38,47,-9,premierleague,2009
Blackburn,38,13,11,14,41,55,-14,premierleague,2009
Stoke City,38,11,14,13,34,48,-14,premierleague,2009
Fulham,38,12,10,16,39,46,-7,premierleague,2009
Sunderland,38,11,11,16,48,56,-8,premierleague,2009
Bolton,38,10,9,19,42,67,-25,premierleague,2009
Wolves,38,9,11,18,32,56,-24,premierleague,2009
Wigan,38,9,9,20,37,79,-42,premierleague,2009
West Ham,38,8,11,19,47,66,-19,premierleague,2009
Burnley,38,8,6,24,42,82,-40,premierleague,2009
Hull City,38,6,12,20,34,75,-41,premierleague,2009
Portsmouth,38,7,7,24,34,66,-32,premierleague,2009
Man Utd,38,23,11,4,78,37,41,premierleague,2010
Chelsea,38,21,8,9,69,33,36,premierleague,2010
Man City,38,21,8,9,60,33,27,premierleague,2010
Arsenal,38,19,11,8,72,43,29,premierleague,2010
Tottenham,38,16,14,8,55,46,9,premierleague,2010
Liverpool,38,17,7,14,59,44,15,premierleague,2010
Everton,38,13,15,10,51,45,6,premierleague,2010
Fulham,38,11,16,11,49,43,6,premierleague,2010
Aston Villa,38,12,12,14,48,59,-11,premierleague,2010
Sunderland,38,12,11,15,45,56,-11,premierleague,2010
West Brom,38,12,11,15,56,71,-15,premierleague,2010
Newcastle,38,11,13,14,56,57,-1,premierleague,2010
Stoke City,38,13,7,18,46,48,-2,premierleague,2010
Bolton,38,12,10,16,52,56,-4,premierleague,2010
Blackburn,38,11,10,17,46,59,-13,premierleague,2010
Wigan,38,9,15,14,40,61,-21,premierleague,2010
Wolves,38,11,7,20,46,66,-20,premierleague,2010
Birmingham,38,8,15,15,37,58,-21,premierleague,2010
Blackpool,38,10,9,19,55,78,-23,premierleague,2010
West Ham,38,7,12,19,43,70,-27,premierleague,2010
Man City,38,28,5,5,93,29,64,premierleague,2011
Man Utd,38,28,5,5,89,33,56,premierleague,2011
Arsenal,38,21,7,10,74,49,25,premierleague,2011
Tottenham,38,20,9,9,66,41,25,premierleague,2011
Newcastle,38,19,8,11,56,51,5,premierleague,2011
Chelsea,38,18,10,10,65,46,19,premierleague,2011
Everton,38,15,11,12,50,40,10,premierleague,2011
Liverpool,38,14,10,14,47,40,7,premierleague,2011
Fulham,38,14,10,14,48,51,-3,premierleague,2011
West Brom,38,13,8,17,45,52,-7,premierleague,2011
Swansea,38,12,11,15,44,51,-7,premierleague,2011
Norwich,38,12,11,15,52,66,-14,premierleague,2011
Sunderland,38,11,12,15,45,46,-1,premierleague,2011
Stoke City,38,11,12,15,36,53,-17,premierleague,2011
Wigan,38,11,10,17,42,62,-20,premierleague,2011
Aston Villa,38,7,17,14,37,53,-16,premierleague,2011
QPR,38,10,7,21,43,66,-23,premierleague,2011
Bolton,38,10,6,22,46,77,-31,premierleague,2011
Blackburn,38,8,7,23,48,78,-30,premierleague,2011
Wolves,38,5,10,23,40,82,-42,premierleague,2011
Man Utd,38,28,5,5,86,43,43,premierleague,2012
Man City,38,23,9,6,66,34,32,premierleague,2012
Chelsea,38,22,9,7,75,39,36,premierleague,2012
Arsenal,38,21,10,7,72,37,35,premierleague,2012
Tottenham,38,21,9,8,66,46,20,premierleague,2012
Everton,38,16,15,7,55,40,15,premierleague,2012
Liverpool,38,16,13,9,71,43,28,premierleague,2012
West Brom,38,14,7,17,53,57,-4,premierleague,2012
Swansea,38,11,13,14,47,51,-4,premierleague,2012
West Ham,38,12,10,16,45,53,-8,premierleague,2012
Norwich,38,10,14,14,41,58,-17,premierleague,2012
Fulham,38,11,10,17,50,60,-10,premierleague,2012
Stoke City,38,9,15,14,34,45,-11,premierleague,2012
Southampton,38,9,14,15,49,60,-11,premierleague,2012
Aston Villa,38,10,11,17,47,69,-22,premierleague,2012
Newcastle,38,11,8,19,45,68,-23,premierleague,2012
Sunderland,38,9,12,17,41,54,-13,premierleague,2012
Wigan,38,9,9,20,47,73,-26,premierleague,2012
Reading,38,6,10,22,43,73,-30,premierleague,2012
QPR,38,4,13,21,30,60,-30,premierleague,2012
Man City,38,27,5,6,102,37,65,premierleague,2013
Liverpool,38,26,6,6,101,50,51,premierleague,2013
Chelsea,38,25,7,6,71,27,44,premierleague,2013
Arsenal,38,24,7,7,68,41,27,premierleague,2013
Everton,38,21,9,8,61,39,22,premierleague,2013
Tottenham,38,21,6,11,55,51,4,premierleague,2013
Man Utd,38,19,7,12,64,43,21,premierleague,2013
Southampton,38,15,11,12,54,46,8,premierleague,2013
Stoke City,38,13,11,14,45,52,-7,premierleague,2013
Newcastle,38,15,4,19,43,59,-16,premierleague,2013
Crystal Palace,38,13,6,19,33,48,-15,premierleague,2013
Swansea,38,11,9,18,54,54,0,premierleague,2013
West Ham,38,11,7,20,40,51,-11,premierleague,2013
Sunderland,38,10,8,20,41,60,-19,premierleague,2013
Aston Villa,38,10,8,20,39,61,-22,premierleague,2013
Hull City,38,10,7,21,38,53,-15,premierleague,2013
West Brom,38,7,15,16,43,59,-16,premierleague,2013
Norwich,38,8,9,21,28,62,-34,premierleague,2013
Fulham,38,9,5,24,40,85,-45,premierleague,2013
Cardiff,38,7,9,22,32,74,-42,premierleague,2013
Chelsea,38,26,9,3,73,32,41,premierleague,2014
Man City,38,24,7,7,83,38,45,premierleague,2014
Arsenal,38,22,9,7,71,36,35,premierleague,2014
Man Utd,38,20,10,8,62,37,25,premierleague,2014
Tottenham,38,19,7,12,58,53,5,premierleague,2014
Liverpool,38,18,8,12,52,48,4,premierleague,2014
Southampton,38,18,6,14,54,33,21,premierleague,2014
Swansea,38,16,8,14,46,49,-3,premierleague,2014
Stoke City,38,15,9,14,48,45,3,premierleague,2014
Crystal Palace,38,13,9,16,47,51,-4,premierleague,2014
Everton,38,12,11,15,48,50,-2,premierleague,2014
West Ham,38,12,11,15,44,47,-3,premierleague,2014
West Brom,38,11,11,16,38,51,-13,premierleague,2014
Leicester,38,11,8,19,46,55,-9,premierleague,2014
Newcastle,38,10,9,19,40,63,-23,premierleague,2014
Sunderland,38,7,17,14,31,53,-22,premierleague,2014
Aston Villa,38,10,8,20,31,57,-26,premierleague,2014
Hull City,38,8,11,19,33,51,-18,premierleague,2014
Burnley,38,7,12,19,28,53,-25,premierleague,2014
QPR,38,8,6,24,42,73,-31,premierleague,2014
Leicester,38,23,12,3,68,36,32,premierleague,2015
Arsenal,38,20,11,7,65,36,29,premierleague,2015
Tottenham,38,19,13,6,69,35,34,premierleague,2015
Man City,38,19,9,10,71,41,30,premierleague,2015
Man Utd,38,19,9,10,49,35,14,premierleague,2015
Southampton,38,18,9,11,59,41,18,premierleague,2015
West Ham,38,16,14,8,65,51,14,premierleague,2015
Liverpool,38,16,12,10,63,50,13,premierleague,2015
Stoke City,38,14,9,15,41,55,-14,premierleague,2015
Chelsea,38,12,14,12,59,53,6,premierleague,2015
Everton,38,11,14,13,59,55,4,premierleague,2015
Swansea,38,12,11,15,42,52,-10,premierleague,2015
Watford,38,12,9,17,40,50,-10,premierleague,2015
West Brom,38,10,13,15,34,48,-14,premierleague,2015
Crystal Palace,38,11,9,18,39,51,-12,premierleague,2015
Bournemouth,38,11,9,18,45,67,-22,premierleague,2015
Sunderland,38,9,12,17,48,62,-14,premierleague,2015
Newcastle,38,9,10,19,44,65,-21,premierleague,2015
Norwich,38,9,7,22,39,67,-28,premierleague,2015
Aston Villa,38,3,8,27,27,76,-49,premierleague,2015
Chelsea,38,30,3,5,85,33,52,premierleague,2016
Tottenham,38,26,8,4,86,26,60,premierleague,2016
Man City,38,23,9,6,80,39,41,premierleague,2016
Liverpool,38,22,10,6,78,42,36,premierleague,2016
Arsenal,38,23,6,9,77,44,33,premierleague,2016
Man Utd,38,18,15,5,54,29,25,premierleague,2016
Everton,38,17,10,11,62,44,18,premierleague,2016
Southampton,38,12,10,16,41,48,-7,premierleague,2016
Bournemouth,38,12,10,16,55,67,-12,premierleague,2016
West Brom,38,12,9,17,43,51,-8,premierleague,2016
West Ham,38,12,9,17,47,64,-17,premierleague,2016
Leicester,38,12,8,18,48,63,-15,premierleague,2016
Stoke City,38,11,11,16,41,56,-15,premierleague,2016
Crystal Palace,38,12,5,21,50,63,-13,premierleague,2016
Swansea,38,12,5,21,45,70,-25,premierleague,2016
Burnley,38,11,7,20,39,55,-16,premierleague,2016
Watford,38,11,7,20,40,68,-28,premierleague,2016
Hull City,38,9,7,22,37,80,-43,premierleague,2016
Middlesbrough,38,5,13,20,27,53,-26,premierleague,2016
Sunderland,38,6,6,26,29,69,-40,premierleague,2016
Man City,38,32,4,2,106,27,79,premierleague,2017
Man Utd,38,25,6,7,68,28,40,premierleague,2017
Tottenham,38,23,8,7,74,36,38,premierleague,2017
Liverpool,38,21,12,5,84,38,46,premierleague,2017
Chelsea,38,21,7,10,62,38,24,premierleague,2017
Arsenal,38,19,6,13,74,51,23,premierleague,2017
Burnley,38,14,12,12,36,39,-3,premierleague,2017
Everton,38,13,10,15,44,58,-14,premierleague,2017
Leicester,38,12,11,15,56,60,-4,premierleague,2017
Newcastle,38,12,8,18,39,47,-8,premierleague,2017
Crystal Palace,38,11,11,16,45,55,-10,premierleague,2017
Bournemouth,38,11,11,16,45,61,-16,premierleague,2017
West Ham,38,10,12,16,48,68,-20,premierleague,2017
Watford,38,11,8,19,44,64,-20,premierleague,2017
Brighton,38,9,13,16,34,54,-20,premierleague,2017
Huddersfield,38,9,10,19,28,58,-30,premierleague,2017
Southampton,38,7,15,16,37,56,-19,premierleague,2017
Swansea,38,8,9,21,28,56,-28,premierleague,2017
Stoke City,38,7,12,19,35,68,-33,premierleague,2017
West Brom,38,6,13,19,31,56,-25,premierleague,2017
Man City,38,32,2,4,95,23,72,premierleague,2018
Liverpool,38,30,7,1,89,22,67,premierleague,2018
Chelsea,38,21,9,8,63,39,24,premierleague,2018
Tottenham,38,23,2,13,67,39,28,premierleague,2018
Arsenal,38,21,7,10,73,51,22,premierleague,2018
Man Utd,38,19,9,10,65,54,11,premierleague,2018
Wolves,38,16,9,13,47,46,1,premierleague,2018
Everton,38,15,9,14,54,46,8,premierleague,2018
Leicester,38,15,7,16,51,48,3,premierleague,2018
West Ham,38,15,7,16,52,55,-3,premierleague,2018
Watford,38,14,8,16,52,59,-7,premierleague,2018
Crystal Palace,38,14,7,17,51,53,-2,premierleague,2018
Newcastle,38,12,9,17,42,48,-6,premierleague,2018
Bournemouth,38,13,6,19,56,70,-14,premierleague,2018
Burnley,38,11,7,20,45,68,-23,premierleague,2018
Southampton,38,9,12,17,45,65,-20,premierleague,2018
Brighton,38,9,9,20,35,60,-25,premierleague,2018
Cardiff,38,10,4,24,34,69,-35,premierleague,2018
Fulham,38,7,5,26,34,81,-47,premierleague,2018
Huddersfield,38,3,7,28,22,76,-54,premierleague,2018
Liverpool,38,32,3,3,85,33,52,premierleague,2019
Man City,38,26,3,9,102,35,67,premierleague,2019
Man Utd,38,18,12,8,66,36,30,premierleague,2019
Chelsea,38,20,6,12,69,54,15,premierleague,2019
Leicester,38,18,8,12,67,41,26,premierleague,2019
Tottenham,38,16,11,11,61,47,14,premierleague,2019
Wolves,38,15,14,9,51,40,11,premierleague,2019
Arsenal,38,14,14,10,56,48,8,premierleague,2019
Sheff Utd,38,14,12,12,39,39,0,premierleague,2019
Burnley,38,15,9,14,43,50,-7,premierleague,2019
Southampton,38,15,7,16,51,60,-9,premierleague,2019
Everton,38,13,10,15,44,56,-12,premierleague,2019
Newcastle,38,11,11,16,38,58,-20,premierleague,2019
Crystal Palace,38,11,10,17,31,50,-19,premierleague,2019
Brighton,38,9,14,15,39,54,-15,premierleague,2019
West Ham,38,10,9,19,49,62,-13,premierleague,2019
Aston Villa,38,9,8,21,41,67,-26,premierleague,2019
Bournemouth,38,9,7,22,40,65,-25,premierleague,2019
Watford,38,8,10,20,36,64,-28,premierleague,2019
Norwich,38,5,6,27,26,75,-49,premierleague,2019
Man City,38,27,5,6,83,32,51,premierleague,2020
Man Utd,38,21,11,6,73,44,29,premierleague,2020
Liverpool,38,20,9,9,68,42,26,premierleague,2020
Chelsea,38,19,10,9,58,36,22,premierleague,2020
Leicester,38,20,6,12,68,50,18,premierleague,2020
West Ham,38,19,8,11,62,47,15,premierleague,2020
Tottenham,38,18,8,12,68,45,23,premierleague,2020
Arsenal,38,18,7,13,55,39,16,premierleague,2020
Leeds,38,18,5,15,62,54,8,premierleague,2020
Everton,38,17,8,13,47,48,-1,premierleague,2020
Aston Villa,38,16,7,15,55,46,9,premierleague,2020
Newcastle,38,12,9,17,46,62,-16,premierleague,2020
Wolves,38,12,9,17,36,52,-16,premierleague,2020
Crystal Palace,38,12,8,18,41,66,-25,premierleague,2020
Southampton,38,12,7,19,47,68,-21,premierleague,2020
Brighton,38,9,14,15,40,46,-6,premierleague,2020
Burnley,38,10,9,19,33,55,-22,premierleague,2020
Fulham,38,5,13,20,27,53,-26,premierleague,2020
West Brom,38,5,11,22,35,76,-41,premierleague,2020
Sheff Utd,38,7,2,29,20,63,-43,premierleague,2020
Man City,38,29,6,3,99,26,73,premierleague,2021
Liverpool,38,28,8,2,94,26,68,premierleague,2021
Chelsea,38,21,11,6,76,33,43,premierleague,2021
Tottenham,38,22,5,11,69,40,29,premierleague,2021
Arsenal,38,22,3,13,61,48,13,premierleague,2021
Man Utd,38,16,10,12,57,57,0,premierleague,2021
West Ham,38,16,8,14,60,51,9,premierleague,2021
Leicester,38,14,10,14,62,59,3,premierleague,2021
Brighton,38,12,15,11,42,44,-2,premierleague,2021
Wolves,38,15,6,17,38,43,-5,premierleague,2021
Newcastle,38,13,10,15,44,62,-18,premierleague,2021
Crystal Palace,38,11,15,12,50,46,4,premierleague,2021
Brentford,38,13,7,18,48,56,-8,premierleague,2021
Aston Villa,38,13,6,19,52,54,-2,premierleague,2021
Southampton,38,9,13,16,43,67,-24,premierleague,2021
Everton,38,11,6,21,43,66,-23,premierleague,2021
Leeds,38,9,11,18,42,79,-37,premierleague,2021
Burnley,38,7,14,17,34,53,-19,premierleague,2021
Watford,38,6,5,27,34,77,-43,premierleague,2021
Norwich,38,5,7,26,23,84,-61,premierleague,2021
Man City,38,28,5,5,94,33,61,premierleague,2022
Arsenal,38,26,6,6,88,43,45,premierleague,2022
Man Utd,38,23,6,9,58,43,15,premierleague,2022
Newcastle,38,19,14,5,68,33,35,premierleague,2022
Liverpool,38,19,10,9,75,47,28,premierleague,2022
Brighton,38,18,8,12,72,53,19,premierleague,2022
Aston Villa,38,18,7,13,51,46,5,premierleague,2022
Tottenham,38,18,6,14,70,63,7,premierleague,2022
Brentford,38,15,14,9,58,46,12,premierleague,2022
Fulham,38,15,7,16,55,53,2,premierleague,2022
Crystal Palace,38,11,12,15,40,49,-9,premierleague,2022
Chelsea,38,11,11,16,38,47,-9,premierleague,2022
Wolves,38,11,8,19,31,58,-27,premierleague,2022
West Ham,38,11,7,20,42,55,-13,premierleague,2022
Bournemouth,38,11,6,21,37,71,-34,premierleague,2022
Nottm Forest,38,9,11,18,38,68,-30,premierleague,2022
Everton,38,8,12,18,34,57,-23,premierleague,2022
Leicester,38,9,7,22,51,68,-17,premierleague,2022
Leeds,38,7,10,21,48,78,-30,premierleague,2022
Southampton,38,6,7,25,36,73,-37,premierleague,2022
Man City,38,28,7,3,96,34,62,premierleague,2023
Arsenal,38,28,5,5,91,29,62,premierleague,2023
Liverpool,38,24,10,4,86,41,45,premierleague,2023
Aston Villa,38,20,8,10,76,61,15,premierleague,2023
Tottenham,38,20,6,12,74,61,13,premierleague,2023
Chelsea,38,18,9,11,77,63,14,premierleague,2023
Newcastle,38,18,6,14,85,62,23,premierleague,2023
Man Utd,38,18,6,14,57,58,-1,premierleague,2023
West Ham,38,14,10,14,60,74,-14,premierleague,2023
Crystal Palace,38,13,10,15,57,58,-1,premierleague,2023
Brighton,38,12,12,14,55,62,-7,premierleague,2023
Bournemouth,38,13,9,16,54,67,-13,premierleague,2023
Fulham,38,13,8,17,55,61,-6,premierleague,2023
Wolves,38,13,7,18,50,65,-15,premierleague,2023
Everton,38,13,9,16,40,51,-11,premierleague,2023
Brentford,38,10,9,19,56,65,-9,premierleague,2023
Nottm Forest,38,9,9,20,49,67,-18,premierleague,2023
Luton,38,6,8,24,52,85,-33,premierleague,2023
Burnley,38,5,9,24,41,78,-37,premierleague,2023
Sheff Utd,38,3,7,28,35,104,-69,premierleague,2023
Liverpool,31,22,7,2,72,30,42,premierleague,2024
Arsenal,31,17,11,3,56,26,30,premierleague,2024
Nottm Forest,31,17,6,8,51,37,14,premierleague,2024
Chelsea,31,15,8,8,54,37,17,premierleague,2024
Newcastle,30,16,5,9,52,39,13,premierleague,2024
Man City,31,15,7,9,57,40,17,premierleague,2024
Aston Villa,31,14,9,8,46,46,0,premierleague,2024
Fulham,31,13,9,9,47,42,5,premierleague,2024
Brighton,31,12,11,8,49,47,2,premierleague,2024
Bournemouth,31,12,9,10,51,40,11,premierleague,2024
Crystal Palace,30,11,10,9,39,35,4,premierleague,2024
Brentford,31,12,6,13,51,47,4,premierleague,2024
Man Utd,31,10,8,13,37,41,-4,premierleague,2024
Tottenham,31,11,4,16,58,45,13,premierleague,2024
Everton,31,7,14,10,33,38,-5,premierleague,2024
West Ham,31,9,8,14,35,52,-17,premierleague,2024
Wolves,31,9,5,17,43,59,-16,premierleague,2024
Ipswich,31,4,8,19,31,65,-34,premierleague,2024
Leicester,31,4,5,22,25,70,-45,premierleague,2024
Southampton,31,2,4,25,23,74,-51,premierleague,2024
Werder Bremen,34,19,10,5,63,30,33,bundesliga,1992
Bayern Munich,34,18,11,5,74,45,29,bundesliga,1992
E. Frankfurt,34,15,12,7,56,39,17,bundesliga,1992
Bor. Dortmund,34,18,5,11,61,43,18,bundesliga,1992
B. Leverkusen,34,14,12,8,64,45,19,bundesliga,1992
Karlsruher SC,34,14,11,9,60,54,6,bundesliga,1992
VfB Stuttgart,34,12,12,10,56,50,6,bundesliga,1992
1.FC K'lautern,34,13,9,12,50,40,10,bundesliga,1992
Bor. M'gladbach,34,13,9,12,59,59,0,bundesliga,1992
FC Schalke 04,34,11,12,11,42,43,-1,bundesliga,1992
Hamburger SV,34,8,15,11,42,44,-2,bundesliga,1992
1.FC Köln,34,12,4,18,41,51,-10,bundesliga,1992
1.FC Nuremberg,34,10,8,16,30,47,-17,bundesliga,1992
Wattenscheid 09,34,10,8,16,46,67,-21,bundesliga,1992
Dynamo Dresden,34,7,13,14,32,49,-17,bundesliga,1992
VfL Bochum,34,8,10,16,45,52,-7,bundesliga,1992
Bayer 05,34,7,10,17,35,64,-29,bundesliga,1992
Saarbrücken,34,5,13,16,37,71,-34,bundesliga,1992
Bayern Munich,34,17,10,7,68,37,31,bundesliga,1993
1.FC K'lautern,34,18,7,9,64,36,28,bundesliga,1993
B. Leverkusen,34,14,11,9,60,47,13,bundesliga,1993
Bor. Dortmund,34,15,9,10,49,45,4,bundesliga,1993
E. Frankfurt,34,15,8,11,57,41,16,bundesliga,1993
Karlsruher SC,34,14,10,10,46,43,3,bundesliga,1993
VfB Stuttgart,34,13,11,10,51,43,8,bundesliga,1993
Werder Bremen,34,13,10,11,51,44,7,bundesliga,1993
MSV Duisburg,34,14,8,12,41,52,-11,bundesliga,1993
Bor. M'gladbach,34,14,7,13,65,59,6,bundesliga,1993
1.FC Köln,34,14,6,14,49,51,-2,bundesliga,1993
Hamburger SV,34,13,8,13,48,52,-4,bundesliga,1993
Dynamo Dresden,34,10,14,10,33,44,-11,bundesliga,1993
FC Schalke 04,34,10,9,15,38,50,-12,bundesliga,1993
SC Freiburg,34,10,8,16,54,57,-3,bundesliga,1993
1.FC Nuremberg,34,10,8,16,41,55,-14,bundesliga,1993
Wattenscheid 09,34,6,11,17,48,70,-22,bundesliga,1993
VfB Leipzig,34,3,11,20,32,69,-37,bundesliga,1993
Bor. Dortmund,34,20,9,5,67,33,34,bundesliga,1994
Werder Bremen,34,20,8,6,70,39,31,bundesliga,1994
SC Freiburg,34,20,6,8,66,44,22,bundesliga,1994
1.FC K'lautern,34,17,12,5,58,41,17,bundesliga,1994
Bor. M'gladbach,34,17,9,8,66,41,25,bundesliga,1994
Bayern Munich,34,15,13,6,55,41,14,bundesliga,1994
B. Leverkusen,34,13,10,11,62,51,11,bundesliga,1994
Karlsruher SC,34,11,14,9,51,47,4,bundesliga,1994
E. Frankfurt,34,12,9,13,41,49,-8,bundesliga,1994
1.FC Köln,34,11,10,13,54,54,0,bundesliga,1994
FC Schalke 04,34,10,11,13,48,54,-6,bundesliga,1994
VfB Stuttgart,34,10,10,14,52,66,-14,bundesliga,1994
Hamburger SV,34,10,9,15,43,50,-7,bundesliga,1994
1860 Munich,34,8,11,15,41,57,-16,bundesliga,1994
Bayer 05,34,7,11,16,37,52,-15,bundesliga,1994
VfL Bochum,34,9,4,21,43,67,-24,bundesliga,1994
MSV Duisburg,34,6,8,20,31,64,-33,bundesliga,1994
Dynamo Dresden,34,4,8,22,33,68,-35,bundesliga,1994
Bor. Dortmund,34,19,11,4,76,38,38,bundesliga,1995
Bayern Munich,34,19,5,10,66,46,20,bundesliga,1995
FC Schalke 04,34,14,14,6,45,36,9,bundesliga,1995
Bor. M'gladbach,34,15,8,11,52,51,1,bundesliga,1995
Hamburger SV,34,12,14,8,52,47,5,bundesliga,1995
Hansa Rostock,34,13,10,11,47,43,4,bundesliga,1995
Karlsruher SC,34,12,12,10,53,47,6,bundesliga,1995
1860 Munich,34,11,12,11,52,46,6,bundesliga,1995
Werder Bremen,34,10,14,10,39,42,-3,bundesliga,1995
VfB Stuttgart,34,10,13,11,59,62,-3,bundesliga,1995
SC Freiburg,34,11,9,14,30,41,-11,bundesliga,1995
1.FC Köln,34,9,13,12,33,35,-2,bundesliga,1995
F. Düsseldorf,34,8,16,10,40,47,-7,bundesliga,1995
B. Leverkusen,34,8,14,12,37,38,-1,bundesliga,1995
FC St. Pauli,34,9,11,14,43,51,-8,bundesliga,1995
1.FC K'lautern,34,6,18,10,31,37,-6,bundesliga,1995
E. Frankfurt,34,7,11,16,43,68,-25,bundesliga,1995
KFC Uerdingen,34,5,11,18,33,56,-23,bundesliga,1995
Bayern Munich,34,20,11,3,68,34,34,bundesliga,1996
B. Leverkusen,34,21,6,7,69,41,28,bundesliga,1996
Bor. Dortmund,34,19,6,9,63,41,22,bundesliga,1996
VfB Stuttgart,34,18,7,9,78,40,38,bundesliga,1996
VfL Bochum,34,14,11,9,54,51,3,bundesliga,1996
Karlsruher SC,34,13,10,11,55,44,11,bundesliga,1996
1860 Munich,34,13,10,11,56,56,0,bundesliga,1996
Werder Bremen,34,14,6,14,53,52,1,bundesliga,1996
MSV Duisburg,34,12,9,13,44,49,-5,bundesliga,1996
1.FC Köln,34,13,5,16,62,62,0,bundesliga,1996
Bor. M'gladbach,34,12,7,15,46,48,-2,bundesliga,1996
FC Schalke 04,34,11,10,13,35,40,-5,bundesliga,1996
Hamburger SV,34,10,11,13,46,60,-14,bundesliga,1996
Arm. Bielefeld,34,11,7,16,46,54,-8,bundesliga,1996
Hansa Rostock,34,11,7,16,35,46,-11,bundesliga,1996
F. Düsseldorf,34,9,6,19,26,57,-31,bundesliga,1996
SC Freiburg,34,8,5,21,43,67,-24,bundesliga,1996
FC St. Pauli,34,7,6,21,32,69,-37,bundesliga,1996
1.FC K'lautern,34,19,11,4,63,39,24,bundesliga,1997
Bayern Munich,34,19,9,6,69,37,32,bundesliga,1997
B. Leverkusen,34,14,13,7,66,39,27,bundesliga,1997
VfB Stuttgart,34,14,10,10,55,49,6,bundesliga,1997
FC Schalke 04,34,13,13,8,38,32,6,bundesliga,1997
Hansa Rostock,34,14,9,11,54,46,8,bundesliga,1997
Werder Bremen,34,14,8,12,43,47,-4,bundesliga,1997
MSV Duisburg,34,11,11,12,43,44,-1,bundesliga,1997
Hamburger SV,34,11,11,12,38,46,-8,bundesliga,1997
Bor. Dortmund,34,11,10,13,57,55,2,bundesliga,1997
Hertha BSC,34,12,7,15,41,53,-12,bundesliga,1997
VfL Bochum,34,11,8,15,41,49,-8,bundesliga,1997
1860 Munich,34,11,8,15,43,54,-11,bundesliga,1997
VfL Wolfsburg,34,11,6,17,38,54,-16,bundesliga,1997
Bor. M'gladbach,34,9,11,14,54,59,-5,bundesliga,1997
Karlsruher SC,34,9,11,14,48,60,-12,bundesliga,1997
1.FC Köln,34,10,6,18,49,64,-15,bundesliga,1997
Arm. Bielefeld,34,8,8,18,43,56,-13,bundesliga,1997
Bayern Munich,34,24,6,4,76,28,48,bundesliga,1998
B. Leverkusen,34,17,12,5,61,30,31,bundesliga,1998
Hertha BSC,34,18,8,8,59,32,27,bundesliga,1998
Bor. Dortmund,34,16,9,9,48,34,14,bundesliga,1998
1.FC K'lautern,34,17,6,11,51,47,4,bundesliga,1998
VfL Wolfsburg,34,15,10,9,54,49,5,bundesliga,1998
Hamburger SV,34,13,11,10,47,46,1,bundesliga,1998
MSV Duisburg,34,13,10,11,48,45,3,bundesliga,1998
1860 Munich,34,11,8,15,49,56,-7,bundesliga,1998
FC Schalke 04,34,10,11,13,41,54,-13,bundesliga,1998
VfB Stuttgart,34,9,12,13,41,48,-7,bundesliga,1998
SC Freiburg,34,10,9,15,36,44,-8,bundesliga,1998
Werder Bremen,34,10,8,16,41,47,-6,bundesliga,1998
Hansa Rostock,34,9,11,14,49,58,-9,bundesliga,1998
E. Frankfurt,34,9,10,15,44,54,-10,bundesliga,1998
1.FC Nuremberg,34,7,16,11,40,50,-10,bundesliga,1998
VfL Bochum,34,7,8,19,40,65,-25,bundesliga,1998
Bor. M'gladbach,34,4,9,21,41,79,-38,bundesliga,1998
Bayern Munich,34,22,7,5,73,28,45,bundesliga,1999
B. Leverkusen,34,21,10,3,74,36,38,bundesliga,1999
Hamburger SV,34,16,11,7,63,39,24,bundesliga,1999
1860 Munich,34,14,11,9,55,48,7,bundesliga,1999
1.FC K'lautern,34,15,5,14,54,59,-5,bundesliga,1999
Hertha BSC,34,13,11,10,39,46,-7,bundesliga,1999
VfL Wolfsburg,34,12,13,9,51,58,-7,bundesliga,1999
VfB Stuttgart,34,14,6,14,44,47,-3,bundesliga,1999
Werder Bremen,34,13,8,13,65,52,13,bundesliga,1999
Unterhaching,34,12,8,14,40,42,-2,bundesliga,1999
Bor. Dortmund,34,9,13,12,41,38,3,bundesliga,1999
SC Freiburg,34,10,10,14,45,50,-5,bundesliga,1999
FC Schalke 04,34,8,15,11,42,44,-2,bundesliga,1999
E. Frankfurt,34,12,5,17,42,44,-2,bundesliga,1999
Hansa Rostock,34,8,14,12,44,60,-16,bundesliga,1999
SSV Ulm 1846,34,9,8,17,36,62,-26,bundesliga,1999
Arm. Bielefeld,34,7,9,18,40,61,-21,bundesliga,1999
MSV Duisburg,34,4,10,20,37,71,-34,bundesliga,1999
Bayern Munich,34,19,6,9,62,37,25,bundesliga,2000
FC Schalke 04,34,18,8,8,65,35,30,bundesliga,2000
Bor. Dortmund,34,16,10,8,62,42,20,bundesliga,2000
B. Leverkusen,34,17,6,11,54,40,14,bundesliga,2000
Hertha BSC,34,18,2,14,58,52,6,bundesliga,2000
SC Freiburg,34,15,10,9,54,37,17,bundesliga,2000
Werder Bremen,34,15,8,11,53,48,5,bundesliga,2000
1.FC K'lautern,34,15,5,14,49,54,-5,bundesliga,2000
VfL Wolfsburg,34,12,11,11,60,45,15,bundesliga,2000
1.FC Köln,34,12,10,12,59,52,7,bundesliga,2000
1860 Munich,34,12,8,14,43,55,-12,bundesliga,2000
Hansa Rostock,34,12,7,15,34,47,-13,bundesliga,2000
Hamburger SV,34,10,11,13,58,58,0,bundesliga,2000
Energie Cottbus,34,12,3,19,38,52,-14,bundesliga,2000
VfB Stuttgart,34,9,11,14,42,49,-7,bundesliga,2000
Unterhaching,34,8,11,15,35,59,-24,bundesliga,2000
E. Frankfurt,34,10,5,19,41,68,-27,bundesliga,2000
VfL Bochum,34,7,6,21,30,67,-37,bundesliga,2000
Bor. Dortmund,34,21,7,6,62,33,29,bundesliga,2001
B. Leverkusen,34,21,6,7,77,38,39,bundesliga,2001
Bayern Munich,34,20,8,6,65,25,40,bundesliga,2001
Hertha BSC,34,18,7,9,61,38,23,bundesliga,2001
FC Schalke 04,34,18,7,9,52,36,16,bundesliga,2001
Werder Bremen,34,17,5,12,54,43,11,bundesliga,2001
1.FC K'lautern,34,17,5,12,62,53,9,bundesliga,2001
VfB Stuttgart,34,13,11,10,47,43,4,bundesliga,2001
1860 Munich,34,15,5,14,59,59,0,bundesliga,2001
VfL Wolfsburg,34,13,7,14,57,49,8,bundesliga,2001
Hamburger SV,34,10,10,14,51,57,-6,bundesliga,2001
Bor. M'gladbach,34,9,12,13,41,53,-12,bundesliga,2001
Energie Cottbus,34,9,8,17,36,60,-24,bundesliga,2001
Hansa Rostock,34,9,7,18,35,54,-19,bundesliga,2001
1.FC Nuremberg,34,10,4,20,34,57,-23,bundesliga,2001
SC Freiburg,34,7,9,18,37,64,-27,bundesliga,2001
1.FC Köln,34,7,8,19,26,61,-35,bundesliga,2001
FC St. Pauli,34,4,10,20,37,70,-33,bundesliga,2001
Bayern Munich,34,23,6,5,70,25,45,bundesliga,2002
VfB Stuttgart,34,17,8,9,53,39,14,bundesliga,2002
Bor. Dortmund,34,15,13,6,51,27,24,bundesliga,2002
Hamburger SV,34,15,11,8,46,36,10,bundesliga,2002
Hertha BSC,34,16,6,12,52,43,9,bundesliga,2002
Werder Bremen,34,16,4,14,51,50,1,bundesliga,2002
FC Schalke 04,34,12,13,9,46,40,6,bundesliga,2002
VfL Wolfsburg,34,13,7,14,39,42,-3,bundesliga,2002
VfL Bochum,34,12,9,13,55,56,-1,bundesliga,2002
1860 Munich,34,12,9,13,44,52,-8,bundesliga,2002
Hannover 96,34,12,7,15,47,57,-10,bundesliga,2002
Bor. M'gladbach,34,11,9,14,43,45,-2,bundesliga,2002
Hansa Rostock,34,11,8,15,35,41,-6,bundesliga,2002
1.FC K'lautern,34,10,10,14,40,42,-2,bundesliga,2002
B. Leverkusen,34,11,7,16,47,56,-9,bundesliga,2002
Arm. Bielefeld,34,8,12,14,35,46,-11,bundesliga,2002
1.FC Nuremberg,34,8,6,20,33,60,-27,bundesliga,2002
Energie Cottbus,34,7,9,18,34,64,-30,bundesliga,2002
Werder Bremen,34,22,8,4,79,38,41,bundesliga,2003
Bayern Munich,34,20,8,6,70,39,31,bundesliga,2003
B. Leverkusen,34,19,8,7,73,39,34,bundesliga,2003
VfB Stuttgart,34,18,10,6,52,24,28,bundesliga,2003
VfL Bochum,34,15,11,8,57,39,18,bundesliga,2003
Bor. Dortmund,34,16,7,11,59,48,11,bundesliga,2003
FC Schalke 04,34,13,11,10,49,42,7,bundesliga,2003
Hamburger SV,34,14,7,13,47,60,-13,bundesliga,2003
Hansa Rostock,34,12,8,14,55,54,1,bundesliga,2003
VfL Wolfsburg,34,13,3,18,56,61,-5,bundesliga,2003
Bor. M'gladbach,34,10,9,15,40,49,-9,bundesliga,2003
Hertha BSC,34,9,12,13,42,59,-17,bundesliga,2003
SC Freiburg,34,10,8,16,42,67,-25,bundesliga,2003
Hannover 96,34,9,10,15,49,63,-14,bundesliga,2003
1.FC K'lautern,34,11,6,17,39,62,-23,bundesliga,2003
E. Frankfurt,34,9,5,20,36,53,-17,bundesliga,2003
1860 Munich,34,8,8,18,32,55,-23,bundesliga,2003
1.FC Köln,34,6,5,23,32,57,-25,bundesliga,2003
Bayern Munich,34,24,5,5,75,33,42,bundesliga,2004
FC Schalke 04,34,20,3,11,56,46,10,bundesliga,2004
Werder Bremen,34,18,5,11,68,37,31,bundesliga,2004
Hertha BSC,34,15,13,6,59,31,28,bundesliga,2004
VfB Stuttgart,34,17,7,10,54,40,14,bundesliga,2004
B. Leverkusen,34,16,9,9,65,44,21,bundesliga,2004
Bor. Dortmund,34,15,10,9,47,44,3,bundesliga,2004
Hamburger SV,34,16,3,15,55,50,5,bundesliga,2004
VfL Wolfsburg,34,15,3,16,49,51,-2,bundesliga,2004
Hannover 96,34,13,6,15,34,36,-2,bundesliga,2004
1.FSV Mainz 05,34,12,7,15,50,55,-5,bundesliga,2004
1.FC K'lautern,34,12,6,16,43,52,-9,bundesliga,2004
Arm. Bielefeld,34,11,7,16,37,49,-12,bundesliga,2004
1.FC Nuremberg,34,10,8,16,55,63,-8,bundesliga,2004
Bor. M'gladbach,34,8,12,14,35,51,-16,bundesliga,2004
VfL Bochum,34,9,8,17,47,68,-21,bundesliga,2004
Hansa Rostock,34,7,9,18,31,65,-34,bundesliga,2004
SC Freiburg,34,3,9,22,30,75,-45,bundesliga,2004
Bayern Munich,34,22,9,3,67,32,35,bundesliga,2005
Werder Bremen,34,21,7,6,79,37,42,bundesliga,2005
Hamburger SV,34,21,5,8,53,30,23,bundesliga,2005
FC Schalke 04,34,16,13,5,47,31,16,bundesliga,2005
B. Leverkusen,34,14,10,10,64,49,15,bundesliga,2005
Hertha BSC,34,12,12,10,52,48,4,bundesliga,2005
Bor. Dortmund,34,11,13,10,45,42,3,bundesliga,2005
1.FC Nuremberg,34,12,8,14,49,51,-2,bundesliga,2005
VfB Stuttgart,34,9,16,9,37,39,-2,bundesliga,2005
Bor. M'gladbach,34,10,12,12,42,50,-8,bundesliga,2005
1.FSV Mainz 05,34,9,11,14,46,47,-1,bundesliga,2005
Hannover 96,34,7,17,10,43,47,-4,bundesliga,2005
Arm. Bielefeld,34,10,7,17,32,47,-15,bundesliga,2005
E. Frankfurt,34,9,9,16,42,51,-9,bundesliga,2005
VfL Wolfsburg,34,7,13,14,33,55,-22,bundesliga,2005
1.FC K'lautern,34,8,9,17,47,71,-24,bundesliga,2005
1.FC Köln,34,7,9,18,49,71,-22,bundesliga,2005
MSV Duisburg,34,5,12,17,34,63,-29,bundesliga,2005
VfB Stuttgart,34,21,7,6,61,37,24,bundesliga,2006
FC Schalke 04,34,21,5,8,53,32,21,bundesliga,2006
Werder Bremen,34,20,6,8,76,40,36,bundesliga,2006
Bayern Munich,34,18,6,10,55,40,15,bundesliga,2006
B. Leverkusen,34,15,6,13,54,49,5,bundesliga,2006
1.FC Nuremberg,34,11,15,8,43,32,11,bundesliga,2006
Hamburger SV,34,10,15,9,43,37,6,bundesliga,2006
VfL Bochum,34,13,6,15,49,50,-1,bundesliga,2006
Bor. Dortmund,34,12,8,14,41,43,-2,bundesliga,2006
Hertha BSC,34,12,8,14,50,55,-5,bundesliga,2006
Hannover 96,34,12,8,14,41,50,-9,bundesliga,2006
Arm. Bielefeld,34,11,9,14,47,49,-2,bundesliga,2006
Energie Cottbus,34,11,8,15,38,49,-11,bundesliga,2006
E. Frankfurt,34,9,13,12,46,58,-12,bundesliga,2006
VfL Wolfsburg,34,8,13,13,37,45,-8,bundesliga,2006
1.FSV Mainz 05,34,8,10,16,34,57,-23,bundesliga,2006
Alem. Aachen,34,9,7,18,46,70,-24,bundesliga,2006
Bor. M'gladbach,34,6,8,20,23,44,-21,bundesliga,2006
Bayern Munich,34,22,10,2,68,21,47,bundesliga,2007
Werder Bremen,34,20,6,8,75,45,30,bundesliga,2007
FC Schalke 04,34,18,10,6,55,32,23,bundesliga,2007
Hamburger SV,34,14,12,8,47,26,21,bundesliga,2007
VfL Wolfsburg,34,15,9,10,58,46,12,bundesliga,2007
VfB Stuttgart,34,16,4,14,57,57,0,bundesliga,2007
B. Leverkusen,34,15,6,13,57,40,17,bundesliga,2007
Hannover 96,34,13,10,11,54,56,-2,bundesliga,2007
E. Frankfurt,34,12,10,12,43,50,-7,bundesliga,2007
Hertha BSC,34,12,8,14,39,44,-5,bundesliga,2007
Karlsruher SC,34,11,10,13,38,53,-15,bundesliga,2007
VfL Bochum,34,10,11,13,48,54,-6,bundesliga,2007
Bor. Dortmund,34,10,10,14,50,62,-12,bundesliga,2007
Energie Cottbus,34,9,9,16,35,56,-21,bundesliga,2007
Arm. Bielefeld,34,8,10,16,35,60,-25,bundesliga,2007
1.FC Nuremberg,34,7,10,17,35,51,-16,bundesliga,2007
Hansa Rostock,34,8,6,20,30,52,-22,bundesliga,2007
MSV Duisburg,34,8,5,21,36,55,-19,bundesliga,2007
VfL Wolfsburg,34,21,6,7,80,41,39,bundesliga,2008
Bayern Munich,34,20,7,7,71,42,29,bundesliga,2008
VfB Stuttgart,34,19,7,8,63,43,20,bundesliga,2008
Hertha BSC,34,19,6,9,48,41,7,bundesliga,2008
Hamburger SV,34,19,4,11,49,47,2,bundesliga,2008
Bor. Dortmund,34,15,14,5,60,37,23,bundesliga,2008
TSG Hoffenheim,34,15,10,9,63,49,14,bundesliga,2008
FC Schalke 04,34,14,8,12,47,35,12,bundesliga,2008
B. Leverkusen,34,14,7,13,59,46,13,bundesliga,2008
Werder Bremen,34,12,9,13,64,50,14,bundesliga,2008
Hannover 96,34,10,10,14,49,69,-20,bundesliga,2008
1.FC Köln,34,11,6,17,35,50,-15,bundesliga,2008
E. Frankfurt,34,8,9,17,39,60,-21,bundesliga,2008
VfL Bochum,34,7,11,16,39,55,-16,bundesliga,2008
Bor. M'gladbach,34,8,7,19,39,62,-23,bundesliga,2008
Energie Cottbus,34,8,6,20,30,57,-27,bundesliga,2008
Karlsruher SC,34,8,5,21,30,54,-24,bundesliga,2008
Arm. Bielefeld,34,4,16,14,29,56,-27,bundesliga,2008
Bayern Munich,34,20,10,4,72,31,41,bundesliga,2009
FC Schalke 04,34,19,8,7,53,31,22,bundesliga,2009
Werder Bremen,34,17,10,7,71,40,31,bundesliga,2009
B. Leverkusen,34,15,14,5,65,38,27,bundesliga,2009
Bor. Dortmund,34,16,9,9,54,42,12,bundesliga,2009
VfB Stuttgart,34,15,10,9,51,41,10,bundesliga,2009
Hamburger SV,34,13,13,8,56,41,15,bundesliga,2009
VfL Wolfsburg,34,14,8,12,64,58,6,bundesliga,2009
1.FSV Mainz 05,34,12,11,11,36,42,-6,bundesliga,2009
E. Frankfurt,34,12,10,12,47,54,-7,bundesliga,2009
TSG Hoffenheim,34,11,9,14,44,42,2,bundesliga,2009
Bor. M'gladbach,34,10,9,15,43,60,-17,bundesliga,2009
1.FC Köln,34,9,11,14,33,42,-9,bundesliga,2009
SC Freiburg,34,9,8,17,35,59,-24,bundesliga,2009
Hannover 96,34,9,6,19,43,67,-24,bundesliga,2009
1.FC Nuremberg,34,8,7,19,32,58,-26,bundesliga,2009
VfL Bochum,34,6,10,18,33,64,-31,bundesliga,2009
Hertha BSC,34,5,9,20,34,56,-22,bundesliga,2009
Bor. Dortmund,34,23,6,5,67,22,45,bundesliga,2010
B. Leverkusen,34,20,8,6,64,44,20,bundesliga,2010
Bayern Munich,34,19,8,7,81,40,41,bundesliga,2010
Hannover 96,34,19,3,12,49,45,4,bundesliga,2010
1.FSV Mainz 05,34,18,4,12,52,39,13,bundesliga,2010
1.FC Nuremberg,34,13,8,13,47,45,2,bundesliga,2010
1.FC K'lautern,34,13,7,14,48,51,-3,bundesliga,2010
Hamburger SV,34,12,9,13,46,52,-6,bundesliga,2010
SC Freiburg,34,13,5,16,41,50,-9,bundesliga,2010
1.FC Köln,34,13,5,16,47,62,-15,bundesliga,2010
TSG Hoffenheim,34,11,10,13,50,50,0,bundesliga,2010
VfB Stuttgart,34,12,6,16,60,59,1,bundesliga,2010
Werder Bremen,34,10,11,13,47,61,-14,bundesliga,2010
FC Schalke 04,34,11,7,16,38,44,-6,bundesliga,2010
VfL Wolfsburg,34,9,11,14,43,48,-5,bundesliga,2010
Bor. M'gladbach,34,10,6,18,48,65,-17,bundesliga,2010
E. Frankfurt,34,9,7,18,31,49,-18,bundesliga,2010
FC St. Pauli,34,8,5,21,35,68,-33,bundesliga,2010
Bor. Dortmund,34,25,6,3,80,25,55,bundesliga,2011
Bayern Munich,34,23,4,7,77,22,55,bundesliga,2011
FC Schalke 04,34,20,4,10,74,44,30,bundesliga,2011
Bor. M'gladbach,34,17,9,8,49,24,25,bundesliga,2011
B. Leverkusen,34,15,9,10,52,44,8,bundesliga,2011
VfB Stuttgart,34,15,8,11,63,46,17,bundesliga,2011
Hannover 96,34,12,12,10,41,45,-4,bundesliga,2011
VfL Wolfsburg,34,13,5,16,47,60,-13,bundesliga,2011
Werder Bremen,34,11,9,14,49,58,-9,bundesliga,2011
1.FC Nuremberg,34,12,6,16,38,49,-11,bundesliga,2011
TSG Hoffenheim,34,10,11,13,41,47,-6,bundesliga,2011
SC Freiburg,34,10,10,14,45,61,-16,bundesliga,2011
1.FSV Mainz 05,34,9,12,13,47,51,-4,bundesliga,2011
FC Augsburg,34,8,14,12,36,49,-13,bundesliga,2011
Hamburger SV,34,8,12,14,35,57,-22,bundesliga,2011
Hertha BSC,34,7,10,17,38,64,-26,bundesliga,2011
1.FC Köln,34,8,6,20,39,75,-36,bundesliga,2011
1.FC K'lautern,34,4,11,19,24,54,-30,bundesliga,2011
Bayern Munich,34,29,4,1,98,18,80,bundesliga,2012
Bor. Dortmund,34,19,9,6,81,42,39,bundesliga,2012
B. Leverkusen,34,19,8,7,65,39,26,bundesliga,2012
FC Schalke 04,34,16,7,11,58,50,8,bundesliga,2012
SC Freiburg,34,14,9,11,45,40,5,bundesliga,2012
E. Frankfurt,34,14,9,11,49,46,3,bundesliga,2012
Hamburger SV,34,14,6,14,42,53,-11,bundesliga,2012
Bor. M'gladbach,34,12,11,11,45,49,-4,bundesliga,2012
Hannover 96,34,13,6,15,60,62,-2,bundesliga,2012
1.FC Nuremberg,34,11,11,12,39,47,-8,bundesliga,2012
VfL Wolfsburg,34,10,13,11,47,52,-5,bundesliga,2012
VfB Stuttgart,34,12,7,15,37,55,-18,bundesliga,2012
1.FSV Mainz 05,34,10,12,12,42,44,-2,bundesliga,2012
Werder Bremen,34,8,10,16,50,66,-16,bundesliga,2012
FC Augsburg,34,8,9,17,33,51,-18,bundesliga,2012
TSG Hoffenheim,34,8,7,19,42,67,-25,bundesliga,2012
F. Düsseldorf,34,7,9,18,39,57,-18,bundesliga,2012
Greuther Fürth,34,4,9,21,26,60,-34,bundesliga,2012
Bayern Munich,34,29,3,2,94,23,71,bundesliga,2013
Bor. Dortmund,34,22,5,7,80,38,42,bundesliga,2013
FC Schalke 04,34,19,7,8,63,43,20,bundesliga,2013
B. Leverkusen,34,19,4,11,60,41,19,bundesliga,2013
VfL Wolfsburg,34,18,6,10,63,50,13,bundesliga,2013
Bor. M'gladbach,34,16,7,11,59,43,16,bundesliga,2013
1.FSV Mainz 05,34,16,5,13,52,54,-2,bundesliga,2013
FC Augsburg,34,15,7,12,47,47,0,bundesliga,2013
TSG Hoffenheim,34,11,11,12,72,70,2,bundesliga,2013
Hannover 96,34,12,6,16,46,59,-13,bundesliga,2013
Hertha BSC,34,11,8,15,40,48,-8,bundesliga,2013
Werder Bremen,34,10,9,15,42,66,-24,bundesliga,2013
E. Frankfurt,34,9,9,16,40,57,-17,bundesliga,2013
SC Freiburg,34,9,9,16,43,61,-18,bundesliga,2013
VfB Stuttgart,34,8,8,18,49,62,-13,bundesliga,2013
Hamburger SV,34,7,6,21,51,75,-24,bundesliga,2013
1.FC Nuremberg,34,5,11,18,37,70,-33,bundesliga,2013
E. Braunschweig,34,6,7,21,29,60,-31,bundesliga,2013
Bayern Munich,34,25,4,5,80,18,62,bundesliga,2014
VfL Wolfsburg,34,20,9,5,72,38,34,bundesliga,2014
Bor. M'gladbach,34,19,9,6,53,26,27,bundesliga,2014
B. Leverkusen,34,17,10,7,62,37,25,bundesliga,2014
FC Augsburg,34,15,4,15,43,43,0,bundesliga,2014
FC Schalke 04,34,13,9,12,42,40,2,bundesliga,2014
Bor. Dortmund,34,13,7,14,47,42,5,bundesliga,2014
TSG Hoffenheim,34,12,8,14,49,55,-6,bundesliga,2014
E. Frankfurt,34,11,10,13,56,62,-6,bundesliga,2014
Werder Bremen,34,11,10,13,50,65,-15,bundesliga,2014
1.FSV Mainz 05,34,9,13,12,45,47,-2,bundesliga,2014
1.FC Köln,34,9,13,12,34,40,-6,bundesliga,2014
Hannover 96,34,9,10,15,40,56,-16,bundesliga,2014
VfB Stuttgart,34,9,9,16,42,60,-18,bundesliga,2014
Hertha BSC,34,9,8,17,36,52,-16,bundesliga,2014
Hamburger SV,34,9,8,17,25,50,-25,bundesliga,2014
SC Freiburg,34,7,13,14,36,47,-11,bundesliga,2014
SC Paderborn,34,7,10,17,31,65,-34,bundesliga,2014
Bayern Munich,34,28,4,2,80,17,63,bundesliga,2015
Bor. Dortmund,34,24,6,4,82,34,48,bundesliga,2015
B. Leverkusen,34,18,6,10,56,40,16,bundesliga,2015
Bor. M'gladbach,34,17,4,13,67,50,17,bundesliga,2015
FC Schalke 04,34,15,7,12,51,49,2,bundesliga,2015
1.FSV Mainz 05,34,14,8,12,46,42,4,bundesliga,2015
Hertha BSC,34,14,8,12,42,42,0,bundesliga,2015
VfL Wolfsburg,34,12,9,13,47,49,-2,bundesliga,2015
1.FC Köln,34,10,13,11,38,42,-4,bundesliga,2015
Hamburger SV,34,11,8,15,40,46,-6,bundesliga,2015
FC Ingolstadt,34,10,10,14,33,42,-9,bundesliga,2015
FC Augsburg,34,9,11,14,42,52,-10,bundesliga,2015
Werder Bremen,34,10,8,16,50,65,-15,bundesliga,2015
Darmstadt 98,34,9,11,14,38,53,-15,bundesliga,2015
TSG Hoffenheim,34,9,10,15,39,54,-15,bundesliga,2015
E. Frankfurt,34,9,9,16,34,52,-18,bundesliga,2015
VfB Stuttgart,34,9,6,19,50,75,-25,bundesliga,2015
Hannover 96,34,7,4,23,31,62,-31,bundesliga,2015
Bayern Munich,34,25,7,2,89,22,67,bundesliga,2016
RB Leipzig,34,20,7,7,66,39,27,bundesliga,2016
Bor. Dortmund,34,18,10,6,72,40,32,bundesliga,2016
TSG Hoffenheim,34,16,14,4,64,37,27,bundesliga,2016
1.FC Köln,34,12,13,9,51,42,9,bundesliga,2016
Hertha BSC,34,15,4,15,43,47,-4,bundesliga,2016
SC Freiburg,34,14,6,14,42,60,-18,bundesliga,2016
Werder Bremen,34,13,6,15,61,64,-3,bundesliga,2016
Bor. M'gladbach,34,12,9,13,45,49,-4,bundesliga,2016
FC Schalke 04,34,11,10,13,45,40,5,bundesliga,2016
E. Frankfurt,34,11,9,14,36,43,-7,bundesliga,2016
B. Leverkusen,34,11,8,15,53,55,-2,bundesliga,2016
FC Augsburg,34,9,11,14,35,51,-16,bundesliga,2016
Hamburger SV,34,10,8,16,33,61,-28,bundesliga,2016
1.FSV Mainz 05,34,10,7,17,44,55,-11,bundesliga,2016
VfL Wolfsburg,34,10,7,17,34,52,-18,bundesliga,2016
FC Ingolstadt,34,8,8,18,36,57,-21,bundesliga,2016
Darmstadt 98,34,7,4,23,28,63,-35,bundesliga,2016
Bayern Munich,34,27,3,4,92,28,64,bundesliga,2017
FC Schalke 04,34,18,9,7,53,37,16,bundesliga,2017
TSG Hoffenheim,34,15,10,9,66,48,18,bundesliga,2017
Bor. Dortmund,34,15,10,9,64,47,17,bundesliga,2017
B. Leverkusen,34,15,10,9,58,44,14,bundesliga,2017
RB Leipzig,34,15,8,11,57,53,4,bundesliga,2017
VfB Stuttgart,34,15,6,13,36,36,0,bundesliga,2017
E. Frankfurt,34,14,7,13,45,45,0,bundesliga,2017
Bor. M'gladbach,34,13,8,13,47,52,-5,bundesliga,2017
Hertha BSC,34,10,13,11,43,46,-3,bundesliga,2017
Werder Bremen,34,10,12,12,37,40,-3,bundesliga,2017
FC Augsburg,34,10,11,13,43,46,-3,bundesliga,2017
Hannover 96,34,10,9,15,44,54,-10,bundesliga,2017
1.FSV Mainz 05,34,9,9,16,38,52,-14,bundesliga,2017
SC Freiburg,34,8,12,14,32,56,-24,bundesliga,2017
VfL Wolfsburg,34,6,15,13,36,48,-12,bundesliga,2017
Hamburger SV,34,8,7,19,29,53,-24,bundesliga,2017
1.FC Köln,34,5,7,22,35,70,-35,bundesliga,2017
Bayern Munich,34,24,6,4,88,32,56,bundesliga,2018
Bor. Dortmund,34,23,7,4,81,44,37,bundesliga,2018
RB Leipzig,34,19,9,6,63,29,34,bundesliga,2018
B. Leverkusen,34,18,4,12,69,52,17,bundesliga,2018
Bor. M'gladbach,34,16,7,11,55,42,13,bundesliga,2018
VfL Wolfsburg,34,16,7,11,62,50,12,bundesliga,2018
E. Frankfurt,34,15,9,10,60,48,12,bundesliga,2018
Werder Bremen,34,14,11,9,58,49,9,bundesliga,2018
TSG Hoffenheim,34,13,12,9,70,52,18,bundesliga,2018
F. Düsseldorf,34,13,5,16,49,65,-16,bundesliga,2018
Hertha BSC,34,11,10,13,49,57,-8,bundesliga,2018
1.FSV Mainz 05,34,12,7,15,46,57,-11,bundesliga,2018
SC Freiburg,34,8,12,14,46,61,-15,bundesliga,2018
FC Schalke 04,34,8,9,17,37,55,-18,bundesliga,2018
FC Augsburg,34,8,8,18,51,71,-20,bundesliga,2018
VfB Stuttgart,34,7,7,20,32,70,-38,bundesliga,2018
Hannover 96,34,5,6,23,31,71,-40,bundesliga,2018
1.FC Nuremberg,34,3,10,21,26,68,-42,bundesliga,2018
Bayern Munich,34,26,4,4,100,32,68,bundesliga,2019
Bor. Dortmund,34,21,6,7,84,41,43,bundesliga,2019
RB Leipzig,34,18,12,4,81,37,44,bundesliga,2019
Bor. M'gladbach,34,20,5,9,66,40,26,bundesliga,2019
B. Leverkusen,34,19,6,9,61,44,17,bundesliga,2019
TSG Hoffenheim,34,15,7,12,53,53,0,bundesliga,2019
VfL Wolfsburg,34,13,10,11,48,46,2,bundesliga,2019
SC Freiburg,34,13,9,12,48,47,1,bundesliga,2019
E. Frankfurt,34,13,6,15,59,60,-1,bundesliga,2019
Hertha BSC,34,11,8,15,48,59,-11,bundesliga,2019
Union Berlin,34,12,5,17,41,58,-17,bundesliga,2019
FC Schalke 04,34,9,12,13,38,58,-20,bundesliga,2019
1.FSV Mainz 05,34,11,4,19,44,65,-21,bundesliga,2019
1.FC Köln,34,10,6,18,51,69,-18,bundesliga,2019
FC Augsburg,34,9,9,16,45,63,-18,bundesliga,2019
Werder Bremen,34,8,7,19,42,69,-27,bundesliga,2019
F. Düsseldorf,34,6,12,16,36,67,-31,bundesliga,2019
SC Paderborn,34,4,8,22,37,74,-37,bundesliga,2019
Bayern Munich,34,24,6,4,99,44,55,bundesliga,2020
RB Leipzig,34,19,8,7,60,32,28,bundesliga,2020
Bor. Dortmund,34,20,4,10,75,46,29,bundesliga,2020
VfL Wolfsburg,34,17,10,7,61,37,24,bundesliga,2020
E. Frankfurt,34,16,12,6,69,53,16,bundesliga,2020
B. Leverkusen,34,14,10,10,53,39,14,bundesliga,2020
Union Berlin,34,12,14,8,50,43,7,bundesliga,2020
Bor. M'gladbach,34,13,10,11,64,56,8,bundesliga,2020
VfB Stuttgart,34,12,9,13,56,55,1,bundesliga,2020
SC Freiburg,34,12,9,13,52,52,0,bundesliga,2020
TSG Hoffenheim,34,11,10,13,52,54,-2,bundesliga,2020
1.FSV Mainz 05,34,10,9,15,39,56,-17,bundesliga,2020
FC Augsburg,34,10,6,18,36,54,-18,bundesliga,2020
Hertha BSC,34,8,11,15,41,52,-11,bundesliga,2020
Arm. Bielefeld,34,9,8,17,26,52,-26,bundesliga,2020
1.FC Köln,34,8,9,17,34,60,-26,bundesliga,2020
Werder Bremen,34,7,10,17,36,57,-21,bundesliga,2020
FC Schalke 04,34,3,7,24,25,86,-61,bundesliga,2020
Bayern Munich,34,24,5,5,97,37,60,bundesliga,2021
Bor. Dortmund,34,22,3,9,85,52,33,bundesliga,2021
B. Leverkusen,34,19,7,8,80,47,33,bundesliga,2021
RB Leipzig,34,17,7,10,72,37,35,bundesliga,2021
Union Berlin,34,16,9,9,50,44,6,bundesliga,2021
SC Freiburg,34,15,10,9,58,46,12,bundesliga,2021
1.FC Köln,34,14,10,10,52,49,3,bundesliga,2021
1.FSV Mainz 05,34,13,7,14,50,45,5,bundesliga,2021
TSG Hoffenheim,34,13,7,14,58,60,-2,bundesliga,2021
Bor. M'gladbach,34,12,9,13,54,61,-7,bundesliga,2021
E. Frankfurt,34,10,12,12,45,49,-4,bundesliga,2021
VfL Wolfsburg,34,12,6,16,43,54,-11,bundesliga,2021
VfL Bochum,34,12,6,16,38,52,-14,bundesliga,2021
FC Augsburg,34,10,8,16,39,56,-17,bundesliga,2021
VfB Stuttgart,34,7,12,15,41,59,-18,bundesliga,2021
Hertha BSC,34,9,6,19,37,71,-34,bundesliga,2021
Arm. Bielefeld,34,5,13,16,27,53,-26,bundesliga,2021
Greuther Fürth,34,3,9,22,28,82,-54,bundesliga,2021
Bayern Munich,34,21,8,5,92,38,54,bundesliga,2022
Bor. Dortmund,34,22,5,7,83,44,39,bundesliga,2022
RB Leipzig,34,20,6,8,64,41,23,bundesliga,2022
Union Berlin,34,18,8,8,51,38,13,bundesliga,2022
SC Freiburg,34,17,8,9,51,44,7,bundesliga,2022
B. Leverkusen,34,14,8,12,57,49,8,bundesliga,2022
E. Frankfurt,34,13,11,10,58,52,6,bundesliga,2022
VfL Wolfsburg,34,13,10,11,57,48,9,bundesliga,2022
1.FSV Mainz 05,34,12,10,12,54,55,-1,bundesliga,2022
Bor. M'gladbach,34,11,10,13,52,55,-3,bundesliga,2022
1.FC Köln,34,10,12,12,49,54,-5,bundesliga,2022
TSG Hoffenheim,34,10,6,18,48,57,-9,bundesliga,2022
Werder Bremen,34,10,6,18,51,64,-13,bundesliga,2022
VfL Bochum,34,10,5,19,40,72,-32,bundesliga,2022
FC Augsburg,34,9,7,18,42,63,-21,bundesliga,2022
VfB Stuttgart,34,7,12,15,45,57,-12,bundesliga,2022
FC Schalke 04,34,7,10,17,35,71,-36,bundesliga,2022
Hertha BSC,34,7,8,19,42,69,-27,bundesliga,2022
B. Leverkusen,34,28,6,0,89,24,65,bundesliga,2023
VfB Stuttgart,34,23,4,7,78,39,39,bundesliga,2023
Bayern Munich,34,23,3,8,94,45,49,bundesliga,2023
RB Leipzig,34,19,8,7,77,39,38,bundesliga,2023
Bor. Dortmund,34,18,9,7,68,43,25,bundesliga,2023
E. Frankfurt,34,11,14,9,51,50,1,bundesliga,2023
TSG Hoffenheim,34,13,7,14,66,66,0,bundesliga,2023
Heidenheim,34,10,12,12,50,55,-5,bundesliga,2023
Werder Bremen,34,11,9,14,48,54,-6,bundesliga,2023
SC Freiburg,34,11,9,14,45,58,-13,bundesliga,2023
FC Augsburg,34,10,9,15,50,60,-10,bundesliga,2023
VfL Wolfsburg,34,10,7,17,41,56,-15,bundesliga,2023
1.FSV Mainz 05,34,7,14,13,39,51,-12,bundesliga,2023
Bor. M'gladbach,34,7,13,14,56,67,-11,bundesliga,2023
Union Berlin,34,9,6,19,33,58,-25,bundesliga,2023
VfL Bochum,34,7,12,15,42,74,-32,bundesliga,2023
1.FC Köln,34,5,12,17,28,60,-32,bundesliga,2023
Darmstadt 98,34,3,8,23,30,86,-56,bundesliga,2023
Bayern Munich,28,21,5,2,81,27,54,bundesliga,2024
B. Leverkusen,28,18,8,2,63,34,29,bundesliga,2024
E. Frankfurt,28,14,6,8,55,42,13,bundesliga,2024
RB Leipzig,29,13,9,7,47,37,10,bundesliga,2024
1.FSV Mainz 05,28,13,7,8,46,32,14,bundesliga,2024
Bor. M'gladbach,28,13,5,10,45,41,4,bundesliga,2024
SC Freiburg,28,12,6,10,38,44,-6,bundesliga,2024
Bor. Dortmund,28,12,5,11,52,43,9,bundesliga,2024
VfB Stuttgart,28,11,7,10,51,44,7,bundesliga,2024
Werder Bremen,28,11,6,11,45,53,-8,bundesliga,2024
FC Augsburg,28,10,9,9,31,39,-8,bundesliga,2024
VfL Wolfsburg,29,10,8,11,51,45,6,bundesliga,2024
Union Berlin,28,9,6,13,26,40,-14,bundesliga,2024
TSG Hoffenheim,28,6,9,13,34,52,-18,bundesliga,2024
FC St. Pauli,28,7,5,16,23,34,-11,bundesliga,2024
Heidenheim,28,6,4,18,32,53,-21,bundesliga,2024
VfL Bochum,28,5,5,18,28,59,-31,bundesliga,2024
Holstein Kiel,28,4,6,18,39,68,-29,bundesliga,2024
Barcelona,38,25,8,5,87,34,53,laliga,1992
Real Madrid,38,24,9,5,75,28,47,laliga,1992
Dep. La Coruña,38,22,10,6,67,33,34,laliga,1992
Valencia,38,19,10,9,60,33,27,laliga,1992
CD Tenerife,38,15,14,9,59,47,12,laliga,1992
Atlético Madrid,38,16,11,11,52,42,10,laliga,1992
Sevilla FC,38,17,9,12,46,44,2,laliga,1992
Athletic,38,17,6,15,53,49,4,laliga,1992
Real Zaragoza,38,11,13,14,37,52,-15,laliga,1992
CA Osasuna,38,12,10,16,42,41,1,laliga,1992
Celta de Vigo,38,9,16,13,25,32,-7,laliga,1992
Sporting Gijón,38,11,12,15,38,57,-19,laliga,1992
Real Sociedad,38,13,8,17,46,59,-13,laliga,1992
Rayo Vallecano,38,8,17,13,40,49,-9,laliga,1992
CD Logroñés,38,11,11,16,32,48,-16,laliga,1992
Real Oviedo,38,11,10,17,42,52,-10,laliga,1992
Albacete,38,11,9,18,54,59,-5,laliga,1992
Español,38,9,11,18,40,56,-16,laliga,1992
Cádiz CF,38,5,12,21,30,70,-40,laliga,1992
Real Burgos,38,4,14,20,29,69,-40,laliga,1992
Barcelona,38,25,6,7,91,42,49,laliga,1993
Dep. La Coruña,38,22,12,4,54,18,36,laliga,1993
Real Zaragoza,38,19,8,11,71,47,24,laliga,1993
Real Madrid,38,19,7,12,61,50,11,laliga,1993
Athletic,38,16,11,11,61,47,14,laliga,1993
Sevilla FC,38,15,12,11,56,42,14,laliga,1993
Valencia,38,14,12,12,55,50,5,laliga,1993
Racing,38,15,8,15,44,42,2,laliga,1993
Real Oviedo,38,12,13,13,43,49,-6,laliga,1993
CD Tenerife,38,15,7,16,49,54,-5,laliga,1993
Real Sociedad,38,12,12,14,39,47,-8,laliga,1993
Atlético Madrid,38,13,9,16,54,54,0,laliga,1993
Albacete,38,10,15,13,49,58,-9,laliga,1993
Sporting Gijón,38,15,5,18,42,57,-15,laliga,1993
Celta de Vigo,38,11,11,16,41,51,-10,laliga,1993
CD Logroñés,38,9,15,14,47,58,-11,laliga,1993
Rayo Vallecano,38,9,13,16,40,58,-18,laliga,1993
Real Valladolid,38,7,15,16,26,51,-25,laliga,1993
UE Lleida,38,7,13,18,28,47,-19,laliga,1993
CA Osasuna,38,8,10,20,34,63,-29,laliga,1993
Real Madrid,38,23,9,6,76,29,47,laliga,1994
Dep. La Coruña,38,20,11,7,68,32,36,laliga,1994
Real Betis,38,15,16,7,46,25,21,laliga,1994
Barcelona,38,18,10,10,60,45,15,laliga,1994
Sevilla FC,38,16,11,11,55,41,14,laliga,1994
Español,38,14,15,9,51,35,16,laliga,1994
Real Zaragoza,38,18,7,13,56,51,5,laliga,1994
Athletic,38,16,10,12,39,42,-3,laliga,1994
Real Oviedo,38,13,13,12,45,42,3,laliga,1994
Valencia,38,13,12,13,53,48,5,laliga,1994
Real Sociedad,38,12,14,12,56,44,12,laliga,1994
Racing,38,13,10,15,42,47,-5,laliga,1994
Celta de Vigo,38,11,14,13,36,48,-12,laliga,1994
Atlético Madrid,38,13,9,16,56,54,2,laliga,1994
CD Tenerife,38,13,9,16,57,57,0,laliga,1994
SD Compostela,38,11,12,15,44,56,-12,laliga,1994
Albacete,38,10,14,14,44,61,-17,laliga,1994
Sporting Gijón,38,8,12,18,42,67,-25,laliga,1994
Real Valladolid,38,8,9,21,25,63,-38,laliga,1994
CD Logroñés,38,2,9,27,15,79,-64,laliga,1994
Atlético Madrid,42,26,9,7,75,32,43,laliga,1995
Valencia,42,26,5,11,77,51,26,laliga,1995
Barcelona,42,22,14,6,72,39,33,laliga,1995
Espanyol,42,20,14,8,63,36,27,laliga,1995
CD Tenerife,42,20,12,10,69,54,15,laliga,1995
Real Madrid,42,20,10,12,75,51,24,laliga,1995
Real Sociedad,42,17,12,13,62,53,9,laliga,1995
Real Betis,42,16,14,12,61,54,7,laliga,1995
Dep. La Coruña,42,16,13,13,63,44,19,laliga,1995
SD Compostela,42,17,8,17,47,54,-7,laliga,1995
Celta de Vigo,42,12,16,14,49,51,-2,laliga,1995
Sevilla FC,42,11,15,16,43,55,-12,laliga,1995
Real Zaragoza,42,11,15,16,51,59,-8,laliga,1995
Athletic,42,11,15,16,44,55,-11,laliga,1995
Real Oviedo,42,12,12,18,48,67,-19,laliga,1995
Real Valladolid,42,11,14,17,57,62,-5,laliga,1995
Racing,42,11,14,17,47,69,-22,laliga,1995
Sporting Gijón,42,13,7,22,51,60,-9,laliga,1995
Rayo Vallecano,42,12,8,22,47,75,-28,laliga,1995
Albacete,42,10,12,20,55,81,-26,laliga,1995
CP Mérida,42,10,12,20,37,62,-25,laliga,1995
UD Salamanca,42,8,9,25,53,82,-29,laliga,1995
Real Madrid,42,27,11,4,85,36,49,laliga,1996
Barcelona,42,28,6,8,102,48,54,laliga,1996
Dep. La Coruña,42,21,14,7,57,30,27,laliga,1996
Real Betis,42,21,14,7,81,46,35,laliga,1996
Atlético Madrid,42,20,11,11,76,64,12,laliga,1996
Athletic,42,16,16,10,72,57,15,laliga,1996
Real Valladolid,42,18,10,14,57,46,11,laliga,1996
Real Sociedad,42,18,9,15,50,47,3,laliga,1996
CD Tenerife,42,15,11,16,69,57,12,laliga,1996
Valencia,42,15,11,16,63,59,4,laliga,1996
SD Compostela,42,13,14,15,52,65,-13,laliga,1996
Espanyol,42,14,9,19,51,57,-6,laliga,1996
Racing,42,11,17,14,52,54,-2,laliga,1996
Real Zaragoza,42,12,14,16,58,66,-8,laliga,1996
Sporting Gijón,42,13,11,18,45,63,-18,laliga,1996
Celta de Vigo,42,12,13,17,51,54,-3,laliga,1996
Real Oviedo,42,12,12,18,49,65,-16,laliga,1996
Rayo Vallecano,42,13,6,23,43,62,-19,laliga,1996
Extremadura,42,11,11,20,35,64,-29,laliga,1996
Sevilla FC,42,12,7,23,50,69,-19,laliga,1996
Hércules CF,42,12,5,25,40,77,-37,laliga,1996
CD Logroñés,42,9,6,27,33,85,-52,laliga,1996
Barcelona,38,23,5,10,78,56,22,laliga,1997
Athletic,38,17,14,7,52,42,10,laliga,1997
Real Sociedad,38,16,15,7,60,37,23,laliga,1997
Real Madrid,38,17,12,9,63,45,18,laliga,1997
RCD Mallorca,38,16,12,10,55,39,16,laliga,1997
Celta de Vigo,38,17,9,12,54,47,7,laliga,1997
Atlético Madrid,38,16,12,10,79,56,23,laliga,1997
Real Betis,38,17,8,13,49,50,-1,laliga,1997
Valencia,38,16,7,15,58,52,6,laliga,1997
Espanyol,38,12,17,9,44,31,13,laliga,1997
Real Valladolid,38,13,11,14,36,47,-11,laliga,1997
Dep. La Coruña,38,12,13,13,44,46,-2,laliga,1997
Real Zaragoza,38,12,12,14,45,53,-8,laliga,1997
Racing,38,12,9,17,46,55,-9,laliga,1997
UD Salamanca,38,12,9,17,46,46,0,laliga,1997
CD Tenerife,38,11,12,15,44,57,-13,laliga,1997
SD Compostela,38,11,11,16,56,66,-10,laliga,1997
Real Oviedo,38,9,13,16,36,51,-15,laliga,1997
CP Mérida,38,9,12,17,33,53,-20,laliga,1997
Sporting Gijón,38,2,7,29,31,80,-49,laliga,1997
Barcelona,38,24,7,7,87,43,44,laliga,1998
Real Madrid,38,21,5,12,77,62,15,laliga,1998
RCD Mallorca,38,20,6,12,48,31,17,laliga,1998
Valencia,38,19,8,11,63,39,24,laliga,1998
Celta de Vigo,38,17,13,8,69,41,28,laliga,1998
Dep. La Coruña,38,17,12,9,55,43,12,laliga,1998
Espanyol,38,16,13,9,49,38,11,laliga,1998
Athletic,38,17,9,12,53,47,6,laliga,1998
Real Zaragoza,38,16,9,13,57,46,11,laliga,1998
Real Sociedad,38,14,12,12,47,43,4,laliga,1998
Real Betis,38,14,7,17,47,58,-11,laliga,1998
Real Valladolid,38,13,9,16,35,44,-9,laliga,1998
Atlético Madrid,38,12,10,16,54,50,4,laliga,1998
Real Oviedo,38,11,12,15,41,57,-16,laliga,1998
Racing,38,10,12,16,41,53,-12,laliga,1998
Alavés,38,11,7,20,36,63,-27,laliga,1998
Extremadura,38,9,12,17,27,53,-26,laliga,1998
Villarreal,38,8,12,18,47,63,-16,laliga,1998
CD Tenerife,38,7,13,18,41,63,-22,laliga,1998
UD Salamanca,38,7,6,25,29,66,-37,laliga,1998
Dep. La Coruña,38,21,6,11,66,44,22,laliga,1999
Barcelona,38,19,7,12,70,46,24,laliga,1999
Valencia,38,18,10,10,59,39,20,laliga,1999
Real Zaragoza,38,16,15,7,60,40,20,laliga,1999
Real Madrid,38,16,14,8,58,48,10,laliga,1999
Alavés,38,17,10,11,41,37,4,laliga,1999
Celta de Vigo,38,15,8,15,45,43,2,laliga,1999
Real Valladolid,38,14,11,13,36,44,-8,laliga,1999
Rayo Vallecano,38,15,7,16,51,53,-2,laliga,1999
RCD Mallorca,38,14,9,15,52,45,7,laliga,1999
Athletic,38,12,14,12,47,57,-10,laliga,1999
Málaga CF,38,11,15,12,55,50,5,laliga,1999
Real Sociedad,38,11,14,13,42,49,-7,laliga,1999
Espanyol,38,12,11,15,51,48,3,laliga,1999
Racing,38,10,16,12,52,50,2,laliga,1999
Real Oviedo,38,11,12,15,44,60,-16,laliga,1999
CD Numancia,38,11,12,15,47,59,-12,laliga,1999
Real Betis,38,11,9,18,33,56,-23,laliga,1999
Atlético Madrid,38,9,11,18,48,64,-16,laliga,1999
Sevilla FC,38,5,13,20,42,67,-25,laliga,1999
Real Madrid,38,24,8,6,81,40,41,laliga,2000
Dep. La Coruña,38,22,7,9,73,44,29,laliga,2000
RCD Mallorca,38,20,11,7,61,43,18,laliga,2000
Barcelona,38,17,12,9,80,57,23,laliga,2000
Valencia,38,18,9,11,55,34,21,laliga,2000
Celta de Vigo,38,16,11,11,51,49,2,laliga,2000
Villarreal,38,16,9,13,58,52,6,laliga,2000
Málaga CF,38,16,8,14,60,61,-1,laliga,2000
Espanyol,38,14,8,16,46,44,2,laliga,2000
Alavés,38,14,7,17,58,59,-1,laliga,2000
UD Las Palmas,38,13,7,18,42,62,-20,laliga,2000
Athletic,38,11,10,17,44,60,-16,laliga,2000
Real Sociedad,38,11,10,17,52,68,-16,laliga,2000
Rayo Vallecano,38,10,13,15,56,68,-12,laliga,2000
CA Osasuna,38,10,12,16,43,54,-11,laliga,2000
Real Valladolid,38,9,15,14,42,50,-8,laliga,2000
Real Zaragoza,38,9,15,14,54,57,-3,laliga,2000
Real Oviedo,38,11,8,19,51,67,-16,laliga,2000
Racing,38,10,9,19,48,62,-14,laliga,2000
CD Numancia,38,10,9,19,40,64,-24,laliga,2000
Valencia,38,21,12,5,51,27,24,laliga,2001
Dep. La Coruña,38,20,8,10,65,41,24,laliga,2001
Real Madrid,38,19,9,10,69,44,25,laliga,2001
Barcelona,38,18,10,10,65,37,28,laliga,2001
Celta de Vigo,38,16,12,10,64,46,18,laliga,2001
Real Betis,38,15,14,9,42,34,8,laliga,2001
Alavés,38,17,3,18,41,44,-3,laliga,2001
Sevilla FC,38,14,11,13,51,40,11,laliga,2001
Athletic,38,14,11,13,54,66,-12,laliga,2001
Málaga CF,38,13,14,11,44,44,0,laliga,2001
Rayo Vallecano,38,13,10,15,46,52,-6,laliga,2001
Real Valladolid,38,13,9,16,45,58,-13,laliga,2001
Real Sociedad,38,13,8,17,48,54,-6,laliga,2001
Espanyol,38,13,8,17,47,56,-9,laliga,2001
Villarreal,38,11,10,17,46,55,-9,laliga,2001
RCD Mallorca,38,11,10,17,40,52,-12,laliga,2001
CA Osasuna,38,10,12,16,36,49,-13,laliga,2001
UD Las Palmas,38,9,13,16,40,50,-10,laliga,2001
CD Tenerife,38,10,8,20,32,58,-26,laliga,2001
Real Zaragoza,38,9,10,19,35,54,-19,laliga,2001
Real Madrid,38,22,12,4,86,42,44,laliga,2002
Real Sociedad,38,22,10,6,71,45,26,laliga,2002
Dep. La Coruña,38,22,6,10,67,47,20,laliga,2002
Celta de Vigo,38,17,10,11,45,36,9,laliga,2002
Valencia,38,17,9,12,56,35,21,laliga,2002
Barcelona,38,15,11,12,63,47,16,laliga,2002
Athletic,38,15,10,13,63,61,2,laliga,2002
Real Betis,38,14,12,12,56,53,3,laliga,2002
RCD Mallorca,38,14,10,14,49,56,-7,laliga,2002
Sevilla FC,38,13,11,14,38,39,-1,laliga,2002
CA Osasuna,38,12,11,15,40,48,-8,laliga,2002
Atlético Madrid,38,12,11,15,51,56,-5,laliga,2002
Málaga CF,38,11,13,14,44,49,-5,laliga,2002
Real Valladolid,38,12,10,16,37,40,-3,laliga,2002
Villarreal,38,11,12,15,44,53,-9,laliga,2002
Racing,38,13,5,20,54,64,-10,laliga,2002
Espanyol,38,10,13,15,48,54,-6,laliga,2002
Recr. Huelva,38,8,12,18,35,61,-26,laliga,2002
Alavés,38,8,11,19,38,68,-30,laliga,2002
Rayo Vallecano,38,7,11,20,31,62,-31,laliga,2002
Valencia,38,23,8,7,71,27,44,laliga,2003
Barcelona,38,21,9,8,63,39,24,laliga,2003
Dep. La Coruña,38,21,8,9,60,34,26,laliga,2003
Real Madrid,38,21,7,10,72,54,18,laliga,2003
Athletic,38,15,11,12,53,49,4,laliga,2003
Sevilla FC,38,15,10,13,56,45,11,laliga,2003
Atlético Madrid,38,15,10,13,51,53,-2,laliga,2003
Villarreal,38,15,9,14,47,49,-2,laliga,2003
Real Betis,38,13,13,12,46,43,3,laliga,2003
Málaga CF,38,15,6,17,50,55,-5,laliga,2003
RCD Mallorca,38,15,6,17,54,66,-12,laliga,2003
Real Zaragoza,38,13,9,16,46,55,-9,laliga,2003
CA Osasuna,38,11,15,12,38,37,1,laliga,2003
Albacete,38,13,8,17,40,48,-8,laliga,2003
Real Sociedad,38,11,13,14,49,53,-4,laliga,2003
Espanyol,38,13,4,21,48,64,-16,laliga,2003
Racing,38,11,10,17,48,63,-15,laliga,2003
Real Valladolid,38,10,11,17,46,56,-10,laliga,2003
Celta de Vigo,38,9,12,17,48,68,-20,laliga,2003
Real Murcia,38,5,11,22,29,57,-28,laliga,2003
Barcelona,38,25,9,4,73,29,44,laliga,2004
Real Madrid,38,25,5,8,71,32,39,laliga,2004
Villarreal,38,18,11,9,69,37,32,laliga,2004
Real Betis,38,16,14,8,62,50,12,laliga,2004
Espanyol,38,17,10,11,54,46,8,laliga,2004
Sevilla FC,38,17,9,12,44,41,3,laliga,2004
Valencia,38,14,16,8,54,39,15,laliga,2004
Dep. La Coruña,38,12,15,11,46,50,-4,laliga,2004
Athletic,38,14,9,15,59,54,5,laliga,2004
Málaga CF,38,15,6,17,40,48,-8,laliga,2004
Atlético Madrid,38,13,11,14,40,34,6,laliga,2004
Real Zaragoza,38,14,8,16,52,57,-5,laliga,2004
Getafe,38,12,11,15,38,46,-8,laliga,2004
Real Sociedad,38,13,8,17,47,56,-9,laliga,2004
CA Osasuna,38,12,10,16,46,65,-19,laliga,2004
Racing,38,12,8,18,41,58,-17,laliga,2004
RCD Mallorca,38,10,9,19,42,63,-21,laliga,2004
Levante,38,9,10,19,39,58,-19,laliga,2004
CD Numancia,38,6,11,21,30,61,-31,laliga,2004
Albacete,38,6,10,22,33,56,-23,laliga,2004
Barcelona,38,25,7,6,80,35,45,laliga,2005
Real Madrid,38,20,10,8,70,40,30,laliga,2005
Valencia,38,19,12,7,58,33,25,laliga,2005
CA Osasuna,38,21,5,12,49,43,6,laliga,2005
Sevilla FC,38,20,8,10,54,39,15,laliga,2005
Celta de Vigo,38,20,4,14,45,33,12,laliga,2005
Villarreal,38,14,15,9,50,39,11,laliga,2005
Dep. La Coruña,38,15,10,13,47,45,2,laliga,2005
Getafe,38,15,9,14,54,49,5,laliga,2005
Atlético Madrid,38,13,13,12,45,37,8,laliga,2005
Real Zaragoza,38,10,16,12,46,51,-5,laliga,2005
Athletic,38,11,12,15,40,46,-6,laliga,2005
RCD Mallorca,38,10,13,15,37,51,-14,laliga,2005
Real Betis,38,10,12,16,34,51,-17,laliga,2005
Espanyol,38,10,11,17,36,56,-20,laliga,2005
Real Sociedad,38,11,7,20,48,65,-17,laliga,2005
Racing,38,9,13,16,36,49,-13,laliga,2005
Alavés,38,9,12,17,35,54,-19,laliga,2005
Cádiz CF,38,8,12,18,36,52,-16,laliga,2005
Málaga CF,38,5,9,24,36,68,-32,laliga,2005
Real Madrid,38,23,7,8,66,40,26,laliga,2006
Barcelona,38,22,10,6,78,33,45,laliga,2006
Sevilla FC,38,21,8,9,64,35,29,laliga,2006
Valencia,38,20,6,12,57,42,15,laliga,2006
Villarreal,38,18,8,12,48,44,4,laliga,2006
Real Zaragoza,38,16,12,10,55,43,12,laliga,2006
Atlético Madrid,38,17,9,12,46,39,7,laliga,2006
Recr. Huelva,38,15,9,14,54,52,2,laliga,2006
Getafe,38,14,10,14,39,33,6,laliga,2006
Racing,38,12,14,12,42,48,-6,laliga,2006
RCD Mallorca,38,14,7,17,41,47,-6,laliga,2006
Espanyol,38,12,13,13,46,53,-7,laliga,2006
Dep. La Coruña,38,12,11,15,32,45,-13,laliga,2006
CA Osasuna,38,13,7,18,51,49,2,laliga,2006
Levante,38,10,12,16,37,53,-16,laliga,2006
Real Betis,38,8,16,14,36,49,-13,laliga,2006
Athletic,38,10,10,18,44,62,-18,laliga,2006
Celta de Vigo,38,10,9,19,40,59,-19,laliga,2006
Real Sociedad,38,8,11,19,32,47,-15,laliga,2006
Gimnàstic,38,7,7,24,34,69,-35,laliga,2006
Real Madrid,38,27,4,7,84,36,48,laliga,2007
Villarreal,38,24,5,9,63,40,23,laliga,2007
Barcelona,38,19,10,9,76,43,33,laliga,2007
Atlético Madrid,38,19,7,12,66,47,19,laliga,2007
Sevilla FC,38,20,4,14,75,49,26,laliga,2007
Racing,38,17,9,12,42,41,1,laliga,2007
RCD Mallorca,38,15,14,9,69,54,15,laliga,2007
UD Almería,38,14,10,14,41,45,-4,laliga,2007
Dep. La Coruña,38,15,7,16,46,47,-1,laliga,2007
Valencia,38,15,6,17,48,62,-14,laliga,2007
Athletic,38,13,11,14,40,43,-3,laliga,2007
Espanyol,38,13,9,16,43,52,-9,laliga,2007
Real Betis,38,12,11,15,45,51,-6,laliga,2007
Getafe,38,12,11,15,44,48,-4,laliga,2007
Real Valladolid,38,11,12,15,42,57,-15,laliga,2007
Recr. Huelva,38,11,11,16,40,60,-20,laliga,2007
CA Osasuna,38,12,7,19,37,44,-7,laliga,2007
Real Zaragoza,38,10,12,16,50,61,-11,laliga,2007
Real Murcia,38,7,9,22,36,65,-29,laliga,2007
Levante,38,7,5,26,33,75,-42,laliga,2007
Barcelona,38,27,6,5,105,35,70,laliga,2008
Real Madrid,38,25,3,10,83,52,31,laliga,2008
Sevilla FC,38,21,7,10,54,39,15,laliga,2008
Atlético Madrid,38,20,7,11,80,57,23,laliga,2008
Villarreal,38,18,11,9,61,54,7,laliga,2008
Valencia,38,18,8,12,68,54,14,laliga,2008
Dep. La Coruña,38,16,10,12,48,47,1,laliga,2008
Málaga CF,38,15,10,13,55,59,-4,laliga,2008
RCD Mallorca,38,14,9,15,53,60,-7,laliga,2008
Espanyol,38,12,11,15,46,49,-3,laliga,2008
UD Almería,38,13,7,18,45,61,-16,laliga,2008
Racing,38,12,10,16,49,48,1,laliga,2008
Athletic,38,12,8,18,47,62,-15,laliga,2008
Sporting Gijón,38,14,1,23,47,79,-32,laliga,2008
CA Osasuna,38,10,13,15,41,47,-6,laliga,2008
Real Valladolid,38,12,7,19,46,58,-12,laliga,2008
Getafe,38,10,12,16,50,56,-6,laliga,2008
Real Betis,38,10,12,16,51,58,-7,laliga,2008
CD Numancia,38,10,5,23,38,69,-31,laliga,2008
Recr. Huelva,38,8,9,21,34,57,-23,laliga,2008
Barcelona,38,31,6,1,98,24,74,laliga,2009
Real Madrid,38,31,3,4,102,35,67,laliga,2009
Valencia,38,21,8,9,59,40,19,laliga,2009
Sevilla FC,38,19,6,13,65,49,16,laliga,2009
RCD Mallorca,38,18,8,12,59,44,15,laliga,2009
Getafe,38,17,7,14,58,48,10,laliga,2009
Villarreal,38,16,8,14,58,57,1,laliga,2009
Athletic,38,15,9,14,50,53,-3,laliga,2009
Atlético Madrid,38,13,8,17,57,61,-4,laliga,2009
Dep. La Coruña,38,13,8,17,35,49,-14,laliga,2009
Espanyol,38,11,11,16,29,46,-17,laliga,2009
CA Osasuna,38,11,10,17,37,46,-9,laliga,2009
UD Almería,38,10,12,16,43,55,-12,laliga,2009
Real Zaragoza,38,10,11,17,46,64,-18,laliga,2009
Sporting Gijón,38,9,13,16,36,51,-15,laliga,2009
Racing,38,9,12,17,42,59,-17,laliga,2009
Málaga CF,38,7,16,15,42,48,-6,laliga,2009
Real Valladolid,38,7,15,16,37,62,-25,laliga,2009
CD Tenerife,38,9,9,20,40,74,-34,laliga,2009
Xerez CD,38,8,10,20,38,66,-28,laliga,2009
Barcelona,38,30,6,2,95,21,74,laliga,2010
Real Madrid,38,29,5,4,102,33,69,laliga,2010
Valencia,38,21,8,9,64,44,20,laliga,2010
Villarreal,38,18,8,12,54,44,10,laliga,2010
Sevilla FC,38,17,7,14,62,61,1,laliga,2010
Athletic,38,18,4,16,59,55,4,laliga,2010
Atlético Madrid,38,17,7,14,62,53,9,laliga,2010
Espanyol,38,15,4,19,46,55,-9,laliga,2010
CA Osasuna,38,13,8,17,45,46,-1,laliga,2010
Sporting Gijón,38,11,14,13,35,42,-7,laliga,2010
Málaga CF,38,13,7,18,54,68,-14,laliga,2010
Racing,38,12,10,16,41,56,-15,laliga,2010
Real Zaragoza,38,12,9,17,40,53,-13,laliga,2010
Levante,38,12,9,17,41,52,-11,laliga,2010
Real Sociedad,38,14,3,21,49,66,-17,laliga,2010
Getafe,38,12,8,18,49,60,-11,laliga,2010
RCD Mallorca,38,12,8,18,41,56,-15,laliga,2010
Dep. La Coruña,38,10,13,15,31,47,-16,laliga,2010
Hércules CF,38,9,8,21,36,60,-24,laliga,2010
UD Almería,38,6,12,20,36,70,-34,laliga,2010
Real Madrid,38,32,4,2,121,32,89,laliga,2011
Barcelona,38,28,7,3,114,29,85,laliga,2011
Valencia,38,17,10,11,59,44,15,laliga,2011
Málaga CF,38,17,7,14,54,53,1,laliga,2011
Atlético Madrid,38,15,11,12,53,46,7,laliga,2011
Levante,38,16,7,15,54,50,4,laliga,2011
CA Osasuna,38,13,15,10,44,61,-17,laliga,2011
RCD Mallorca,38,14,10,14,42,46,-4,laliga,2011
Sevilla FC,38,13,11,14,48,47,1,laliga,2011
Athletic,38,12,13,13,49,52,-3,laliga,2011
Getafe,38,12,11,15,40,51,-11,laliga,2011
Real Sociedad,38,12,11,15,46,52,-6,laliga,2011
Real Betis,38,13,8,17,47,56,-9,laliga,2011
Espanyol,38,12,10,16,46,56,-10,laliga,2011
Rayo Vallecano,38,13,4,21,53,73,-20,laliga,2011
Real Zaragoza,38,12,7,19,36,61,-25,laliga,2011
Granada CF,38,12,6,20,35,56,-21,laliga,2011
Villarreal,38,9,14,15,39,53,-14,laliga,2011
Sporting Gijón,38,10,7,21,42,69,-27,laliga,2011
Racing,38,4,15,19,28,63,-35,laliga,2011
Barcelona,38,32,4,2,115,40,75,laliga,2012
Real Madrid,38,26,7,5,103,42,61,laliga,2012
Atlético Madrid,38,23,7,8,65,31,34,laliga,2012
Real Sociedad,38,18,12,8,70,49,21,laliga,2012
Valencia,38,19,8,11,67,54,13,laliga,2012
Málaga CF,38,16,9,13,53,50,3,laliga,2012
Real Betis,38,16,8,14,57,56,1,laliga,2012
Rayo Vallecano,38,16,5,17,50,66,-16,laliga,2012
Sevilla FC,38,14,8,16,58,54,4,laliga,2012
Getafe,38,13,8,17,43,57,-14,laliga,2012
Levante,38,12,10,16,40,57,-17,laliga,2012
Athletic,38,12,9,17,44,65,-21,laliga,2012
Espanyol,38,11,11,16,43,52,-9,laliga,2012
Real Valladolid,38,11,10,17,49,58,-9,laliga,2012
Granada CF,38,11,9,18,37,54,-17,laliga,2012
CA Osasuna,38,10,9,19,33,50,-17,laliga,2012
Celta de Vigo,38,10,7,21,37,52,-15,laliga,2012
RCD Mallorca,38,9,9,20,43,72,-29,laliga,2012
Dep. La Coruña,38,8,11,19,47,70,-23,laliga,2012
Real Zaragoza,38,9,7,22,37,62,-25,laliga,2012
Atlético Madrid,38,28,6,4,77,26,51,laliga,2013
Barcelona,38,27,6,5,100,33,67,laliga,2013
Real Madrid,38,27,6,5,104,38,66,laliga,2013
Athletic,38,20,10,8,66,39,27,laliga,2013
Sevilla FC,38,18,9,11,69,52,17,laliga,2013
Villarreal,38,17,8,13,60,44,16,laliga,2013
Real Sociedad,38,16,11,11,62,55,7,laliga,2013
Valencia,38,13,10,15,51,53,-2,laliga,2013
Celta de Vigo,38,14,7,17,49,54,-5,laliga,2013
Levante,38,12,12,14,35,43,-8,laliga,2013
Málaga CF,38,12,9,17,39,46,-7,laliga,2013
Rayo Vallecano,38,13,4,21,46,80,-34,laliga,2013
Getafe,38,11,9,18,35,54,-19,laliga,2013
Espanyol,38,11,9,18,41,51,-10,laliga,2013
Granada CF,38,12,5,21,32,56,-24,laliga,2013
Elche CF,38,9,13,16,30,50,-20,laliga,2013
UD Almería,38,11,7,20,43,71,-28,laliga,2013
CA Osasuna,38,10,9,19,32,62,-30,laliga,2013
Real Valladolid,38,7,15,16,38,60,-22,laliga,2013
Real Betis,38,6,7,25,36,78,-42,laliga,2013
Barcelona,38,30,4,4,110,21,89,laliga,2014
Real Madrid,38,30,2,6,118,38,80,laliga,2014
Atlético Madrid,38,23,9,6,67,29,38,laliga,2014
Valencia,38,22,11,5,70,32,38,laliga,2014
Sevilla FC,38,23,7,8,71,45,26,laliga,2014
Villarreal,38,16,12,10,48,37,11,laliga,2014
Athletic,38,15,10,13,42,41,1,laliga,2014
Celta de Vigo,38,13,12,13,47,44,3,laliga,2014
Málaga CF,38,14,8,16,42,48,-6,laliga,2014
Espanyol,38,13,10,15,47,51,-4,laliga,2014
Rayo Vallecano,38,15,4,19,46,68,-22,laliga,2014
Real Sociedad,38,11,13,14,44,51,-7,laliga,2014
Elche CF,38,11,8,19,35,62,-27,laliga,2014
Levante,38,9,10,19,34,67,-33,laliga,2014
Getafe,38,10,7,21,33,64,-31,laliga,2014
Dep. La Coruña,38,7,14,17,35,60,-25,laliga,2014
Granada CF,38,7,14,17,29,64,-35,laliga,2014
SD Eibar,38,9,8,21,34,55,-21,laliga,2014
UD Almería,38,8,8,22,35,64,-29,laliga,2014
Córdoba CF,38,3,11,24,22,68,-46,laliga,2014
Barcelona,38,29,4,5,112,29,83,laliga,2015
Real Madrid,38,28,6,4,110,34,76,laliga,2015
Atlético Madrid,38,28,4,6,63,18,45,laliga,2015
Villarreal,38,18,10,10,44,35,9,laliga,2015
Athletic,38,18,8,12,58,45,13,laliga,2015
Celta de Vigo,38,17,9,12,51,59,-8,laliga,2015
Sevilla FC,38,14,10,14,51,50,1,laliga,2015
Málaga CF,38,12,12,14,38,35,3,laliga,2015
Real Sociedad,38,13,9,16,45,48,-3,laliga,2015
Real Betis,38,11,12,15,34,52,-18,laliga,2015
UD Las Palmas,38,12,8,18,45,53,-8,laliga,2015
Valencia,38,11,11,16,46,48,-2,laliga,2015
SD Eibar,38,11,10,17,49,61,-12,laliga,2015
Espanyol,38,12,7,19,40,74,-34,laliga,2015
Dep. La Coruña,38,8,18,12,45,61,-16,laliga,2015
Granada CF,38,10,9,19,46,69,-23,laliga,2015
Sporting Gijón,38,10,9,19,40,62,-22,laliga,2015
Rayo Vallecano,38,9,11,18,52,73,-21,laliga,2015
Getafe,38,9,9,20,37,67,-30,laliga,2015
Levante,38,8,8,22,37,70,-33,laliga,2015
Real Madrid,38,29,6,3,106,41,65,laliga,2016
Barcelona,38,28,6,4,116,37,79,laliga,2016
Atlético Madrid,38,23,9,6,70,27,43,laliga,2016
Sevilla FC,38,21,9,8,69,49,20,laliga,2016
Villarreal,38,19,10,9,56,33,23,laliga,2016
Real Sociedad,38,19,7,12,59,53,6,laliga,2016
Athletic,38,19,6,13,53,43,10,laliga,2016
Espanyol,38,15,11,12,49,50,-1,laliga,2016
Alavés,38,14,13,11,41,43,-2,laliga,2016
SD Eibar,38,15,9,14,56,51,5,laliga,2016
Málaga CF,38,12,10,16,49,55,-6,laliga,2016
Valencia,38,13,7,18,56,65,-9,laliga,2016
Celta de Vigo,38,13,6,19,53,69,-16,laliga,2016
UD Las Palmas,38,10,9,19,53,74,-21,laliga,2016
Real Betis,38,10,9,19,41,64,-23,laliga,2016
Dep. La Coruña,38,8,12,18,43,61,-18,laliga,2016
CD Leganés,38,8,11,19,36,55,-19,laliga,2016
Sporting Gijón,38,7,10,21,42,72,-30,laliga,2016
CA Osasuna,38,4,10,24,40,94,-54,laliga,2016
Granada CF,38,4,8,26,30,82,-52,laliga,2016
Barcelona,38,28,9,1,99,29,70,laliga,2017
Atlético Madrid,38,23,10,5,58,22,36,laliga,2017
Real Madrid,38,22,10,6,94,44,50,laliga,2017
Valencia,38,22,7,9,65,38,27,laliga,2017
Villarreal,38,18,7,13,57,50,7,laliga,2017
Real Betis,38,18,6,14,60,61,-1,laliga,2017
Sevilla FC,38,17,7,14,49,58,-9,laliga,2017
Getafe,38,15,10,13,42,33,9,laliga,2017
SD Eibar,38,14,9,15,44,50,-6,laliga,2017
Girona,38,14,9,15,50,59,-9,laliga,2017
Espanyol,38,12,13,13,36,42,-6,laliga,2017
Real Sociedad,38,14,7,17,66,59,7,laliga,2017
Celta de Vigo,38,13,10,15,59,60,-1,laliga,2017
Alavés,38,15,2,21,40,50,-10,laliga,2017
Levante,38,11,13,14,44,58,-14,laliga,2017
Athletic,38,10,13,15,41,49,-8,laliga,2017
CD Leganés,38,12,7,19,34,51,-17,laliga,2017
Dep. La Coruña,38,6,11,21,38,76,-38,laliga,2017
UD Las Palmas,38,5,7,26,24,74,-50,laliga,2017
Málaga CF,38,5,5,28,24,61,-37,laliga,2017
Barcelona,38,26,9,3,90,36,54,laliga,2018
Atlético Madrid,38,22,10,6,55,29,26,laliga,2018
Real Madrid,38,21,5,12,63,46,17,laliga,2018
Valencia,38,15,16,7,51,35,16,laliga,2018
Getafe,38,15,14,9,48,35,13,laliga,2018
Sevilla FC,38,17,8,13,62,47,15,laliga,2018
Espanyol,38,14,11,13,48,50,-2,laliga,2018
Athletic,38,13,14,11,41,45,-4,laliga,2018
Real Sociedad,38,13,11,14,45,46,-1,laliga,2018
Real Betis,38,14,8,16,44,52,-8,laliga,2018
Alavés,38,13,11,14,39,50,-11,laliga,2018
SD Eibar,38,11,14,13,46,50,-4,laliga,2018
CD Leganés,38,11,12,15,37,43,-6,laliga,2018
Villarreal,38,10,14,14,49,52,-3,laliga,2018
Levante,38,11,11,16,59,66,-7,laliga,2018
Real Valladolid,38,10,11,17,32,51,-19,laliga,2018
Celta de Vigo,38,10,11,17,53,62,-9,laliga,2018
Girona,38,9,10,19,37,53,-16,laliga,2018
SD Huesca,38,7,12,19,43,65,-22,laliga,2018
Rayo Vallecano,38,8,8,22,41,70,-29,laliga,2018
Real Madrid,38,26,9,3,70,25,45,laliga,2019
Barcelona,38,25,7,6,86,38,48,laliga,2019
Atlético Madrid,38,18,16,4,51,27,24,laliga,2019
Sevilla FC,38,19,13,6,54,34,20,laliga,2019
Villarreal,38,18,6,14,63,49,14,laliga,2019
Real Sociedad,38,16,8,14,56,48,8,laliga,2019
Granada CF,38,16,8,14,52,45,7,laliga,2019
Getafe,38,14,12,12,43,37,6,laliga,2019
Valencia,38,14,11,13,46,53,-7,laliga,2019
CA Osasuna,38,13,13,12,46,54,-8,laliga,2019
Athletic,38,13,12,13,41,38,3,laliga,2019
Levante,38,14,7,17,47,53,-6,laliga,2019
Real Valladolid,38,9,15,14,32,43,-11,laliga,2019
SD Eibar,38,11,9,18,39,56,-17,laliga,2019
Real Betis,38,10,11,17,48,60,-12,laliga,2019
Alavés,38,10,9,19,34,59,-25,laliga,2019
Celta de Vigo,38,7,16,15,37,49,-12,laliga,2019
CD Leganés,38,8,12,18,30,51,-21,laliga,2019
RCD Mallorca,38,9,6,23,40,65,-25,laliga,2019
Espanyol,38,5,10,23,27,58,-31,laliga,2019
Atlético Madrid,38,26,8,4,67,25,42,laliga,2020
Real Madrid,38,25,9,4,67,28,39,laliga,2020
Barcelona,38,24,7,7,85,38,47,laliga,2020
Sevilla FC,38,24,5,9,53,33,20,laliga,2020
Real Sociedad,38,17,11,10,59,38,21,laliga,2020
Real Betis,38,17,10,11,50,50,0,laliga,2020
Villarreal,38,15,13,10,60,44,16,laliga,2020
Celta de Vigo,38,14,11,13,55,57,-2,laliga,2020
Athletic,38,11,13,14,46,42,4,laliga,2020
Granada CF,38,13,7,18,47,65,-18,laliga,2020
CA Osasuna,38,11,11,16,37,48,-11,laliga,2020
Cádiz CF,38,11,11,16,36,58,-22,laliga,2020
Valencia,38,10,13,15,50,53,-3,laliga,2020
Levante,38,9,14,15,46,57,-11,laliga,2020
Getafe,38,9,11,18,28,43,-15,laliga,2020
Alavés,38,9,11,18,36,57,-21,laliga,2020
Elche CF,38,8,12,18,34,55,-21,laliga,2020
SD Huesca,38,7,13,18,34,53,-19,laliga,2020
Real Valladolid,38,5,16,17,34,57,-23,laliga,2020
SD Eibar,38,6,12,20,29,52,-23,laliga,2020
Real Madrid,38,26,8,4,80,31,49,laliga,2021
Barcelona,38,21,10,7,68,38,30,laliga,2021
Atlético Madrid,38,21,8,9,65,43,22,laliga,2021
Sevilla FC,38,18,16,4,53,30,23,laliga,2021
Real Betis,38,19,8,11,62,40,22,laliga,2021
Real Sociedad,38,17,11,10,40,37,3,laliga,2021
Villarreal,38,16,11,11,63,37,26,laliga,2021
Athletic,38,14,13,11,43,36,7,laliga,2021
Valencia,38,11,15,12,48,53,-5,laliga,2021
CA Osasuna,38,12,11,15,37,51,-14,laliga,2021
Celta de Vigo,38,12,10,16,43,43,0,laliga,2021
Rayo Vallecano,38,11,9,18,39,50,-11,laliga,2021
Elche CF,38,11,9,18,40,52,-12,laliga,2021
Espanyol,38,10,12,16,40,53,-13,laliga,2021
Getafe,38,8,15,15,33,41,-8,laliga,2021
RCD Mallorca,38,10,9,19,36,63,-27,laliga,2021
Cádiz CF,38,8,15,15,35,51,-16,laliga,2021
Granada CF,38,8,14,16,44,61,-17,laliga,2021
Levante,38,8,11,19,51,76,-25,laliga,2021
Alavés,38,8,7,23,31,65,-34,laliga,2021
Barcelona,38,28,4,6,70,20,50,laliga,2022
Real Madrid,38,24,6,8,75,36,39,laliga,2022
Atlético Madrid,38,23,8,7,70,33,37,laliga,2022
Real Sociedad,38,21,8,9,51,35,16,laliga,2022
Villarreal,38,19,7,12,59,40,19,laliga,2022
Real Betis,38,17,9,12,46,41,5,laliga,2022
CA Osasuna,38,15,8,15,37,42,-5,laliga,2022
Athletic,38,14,9,15,47,43,4,laliga,2022
RCD Mallorca,38,14,8,16,37,43,-6,laliga,2022
Girona,38,13,10,15,58,55,3,laliga,2022
Sevilla FC,38,13,10,15,47,54,-7,laliga,2022
Rayo Vallecano,38,13,10,15,45,53,-8,laliga,2022
Celta de Vigo,38,11,10,17,43,53,-10,laliga,2022
Valencia,38,11,9,18,42,45,-3,laliga,2022
Getafe,38,10,12,16,34,45,-11,laliga,2022
Cádiz CF,38,10,12,16,30,53,-23,laliga,2022
UD Almería,38,11,8,19,49,65,-16,laliga,2022
Real Valladolid,38,11,7,20,33,63,-30,laliga,2022
Espanyol,38,8,13,17,52,69,-17,laliga,2022
Elche CF,38,5,10,23,30,67,-37,laliga,2022
Real Madrid,38,29,8,1,87,26,61,laliga,2023
Barcelona,38,26,7,5,79,44,35,laliga,2023
Girona,38,25,6,7,85,46,39,laliga,2023
Atlético Madrid,38,24,4,10,70,43,27,laliga,2023
Athletic,38,19,11,8,61,37,24,laliga,2023
Real Sociedad,38,16,12,10,51,39,12,laliga,2023
Real Betis,38,14,15,9,48,45,3,laliga,2023
Villarreal,38,14,11,13,65,65,0,laliga,2023
Valencia,38,13,10,15,40,45,-5,laliga,2023
Alavés,38,12,10,16,36,46,-10,laliga,2023
CA Osasuna,38,12,9,17,45,56,-11,laliga,2023
Getafe,38,10,13,15,42,54,-12,laliga,2023
Sevilla FC,38,10,11,17,48,54,-6,laliga,2023
Celta de Vigo,38,10,11,17,46,57,-11,laliga,2023
RCD Mallorca,38,8,16,14,33,44,-11,laliga,2023
UD Las Palmas,38,10,10,18,33,47,-14,laliga,2023
Rayo Vallecano,38,8,14,16,29,48,-19,laliga,2023
Cádiz CF,38,6,15,17,26,55,-29,laliga,2023
UD Almería,38,3,12,23,43,75,-32,laliga,2023
Granada CF,38,4,9,25,38,79,-41,laliga,2023
Barcelona,30,21,4,5,83,29,54,laliga,2024
Real Madrid,30,19,6,5,63,31,32,laliga,2024
Atlético Madrid,30,17,9,4,49,24,25,laliga,2024
Athletic,30,14,12,4,46,24,22,laliga,2024
Villarreal,29,13,9,7,51,39,12,laliga,2024
Real Betis,30,13,9,8,41,37,4,laliga,2024
Celta de Vigo,30,12,7,11,44,43,1,laliga,2024
Real Sociedad,30,12,5,13,30,32,-2,laliga,2024
Rayo Vallecano,30,10,10,10,33,35,-2,laliga,2024
RCD Mallorca,30,11,7,12,29,37,-8,laliga,2024
Getafe,30,10,9,11,30,25,5,laliga,2024
Valencia,31,9,10,12,35,47,-12,laliga,2024
Sevilla FC,31,9,9,13,34,42,-8,laliga,2024
CA Osasuna,30,7,14,9,34,43,-9,laliga,2024
Girona,30,9,7,14,37,46,-9,laliga,2024
Espanyol,29,8,8,13,31,40,-9,laliga,2024
Alavés,30,7,9,14,33,44,-11,laliga,2024
CD Leganés,30,6,10,14,29,47,-18,laliga,2024
UD Las Palmas,30,6,8,16,34,51,-17,laliga,2024
Real Valladolid,30,4,4,22,19,69,-50,laliga,2024
Milan,34,18,14,2,65,32,33,seriea,1992
Inter,34,17,12,5,59,36,23,seriea,1992
AC Parma,34,16,9,9,47,34,13,seriea,1992
Juventus,34,15,9,10,59,47,12,seriea,1992
Lazio,34,13,12,9,65,51,14,seriea,1992
Cagliari,34,14,9,11,45,33,12,seriea,1992
Sampdoria,34,12,12,10,50,48,2,seriea,1992
Atalanta,34,14,8,12,42,44,-2,seriea,1992
Torino,34,9,17,8,38,38,0,seriea,1992
AS Roma,34,8,17,9,42,39,3,seriea,1992
Napoli,34,10,12,12,49,50,-1,seriea,1992
Foggia,34,10,12,12,39,55,-16,seriea,1992
Genoa,34,7,17,10,41,55,-14,seriea,1992
Brescia,34,9,12,13,36,44,-8,seriea,1992
Udinese,34,10,10,14,42,48,-6,seriea,1992
Fiorentina,34,8,14,12,53,56,-3,seriea,1992
Ancona,34,6,7,21,39,73,-34,seriea,1992
Pescara,34,6,5,23,47,75,-28,seriea,1992
Milan,34,19,12,3,36,15,21,seriea,1993
Juventus,34,17,13,4,58,25,33,seriea,1993
Lazio,34,17,10,7,55,40,15,seriea,1993
Sampdoria,34,18,8,8,64,39,25,seriea,1993
AC Parma,34,17,7,10,50,35,15,seriea,1993
Napoli,34,12,12,10,41,35,6,seriea,1993
AS Roma,34,10,15,9,35,30,5,seriea,1993
Torino,34,11,12,11,39,37,2,seriea,1993
Foggia,34,10,13,11,46,46,0,seriea,1993
Genoa,34,8,16,10,32,40,-8,seriea,1993
Cremonese,34,9,14,11,41,41,0,seriea,1993
Cagliari,34,10,12,12,39,48,-9,seriea,1993
Inter,34,11,9,14,46,45,1,seriea,1993
Reggiana,34,10,11,13,29,37,-8,seriea,1993
Piacenza,34,8,14,12,32,43,-11,seriea,1993
Udinese,34,7,14,13,35,48,-13,seriea,1993
Atalanta,34,5,11,18,35,65,-30,seriea,1993
Lecce,34,3,5,26,28,72,-44,seriea,1993
Juventus,34,23,4,7,59,32,27,seriea,1994
AC Parma,34,18,9,7,51,31,20,seriea,1994
Lazio,34,19,6,9,69,34,35,seriea,1994
Milan,34,17,9,8,53,32,21,seriea,1994
AS Roma,34,16,11,7,46,25,21,seriea,1994
Inter,34,14,10,10,39,34,5,seriea,1994
Napoli,34,13,12,9,40,45,-5,seriea,1994
Sampdoria,34,13,11,10,51,37,14,seriea,1994
Cagliari,34,13,10,11,40,39,1,seriea,1994
Fiorentina,34,12,11,11,61,57,4,seriea,1994
Torino,34,12,9,13,44,48,-4,seriea,1994
Bari,34,12,8,14,40,43,-3,seriea,1994
Cremonese,34,11,8,15,35,38,-3,seriea,1994
Genoa,34,10,10,14,34,49,-15,seriea,1994
Padova,34,12,4,18,37,58,-21,seriea,1994
Foggia,34,8,10,16,32,50,-18,seriea,1994
Reggiana,34,4,6,24,24,56,-32,seriea,1994
Brescia,34,2,6,26,18,65,-47,seriea,1994
Milan,34,21,10,3,60,24,36,seriea,1995
Juventus,34,19,8,7,58,35,23,seriea,1995
Lazio,34,17,8,9,66,38,28,seriea,1995
Fiorentina,34,17,8,9,53,41,12,seriea,1995
AS Roma,34,16,10,8,51,34,17,seriea,1995
AC Parma,34,16,10,8,44,31,13,seriea,1995
Inter,34,15,9,10,51,30,21,seriea,1995
Sampdoria,34,14,10,10,59,47,12,seriea,1995
Vicenza,34,13,10,11,36,37,-1,seriea,1995
Cagliari,34,11,8,15,34,47,-13,seriea,1995
Udinese,34,11,8,15,41,49,-8,seriea,1995
Napoli,34,10,11,13,28,41,-13,seriea,1995
Atalanta BC,34,11,6,17,38,50,-12,seriea,1995
Piacenza,34,9,10,15,31,48,-17,seriea,1995
Bari,34,8,8,18,49,71,-22,seriea,1995
Torino,34,6,11,17,28,46,-18,seriea,1995
Cremonese,34,5,12,17,37,57,-20,seriea,1995
Padova,34,7,3,24,41,79,-38,seriea,1995
Juventus,34,17,14,3,51,24,27,seriea,1996
AC Parma,34,18,9,7,41,26,15,seriea,1996
Inter,34,15,14,5,51,35,16,seriea,1996
Lazio,34,15,10,9,54,37,17,seriea,1996
Udinese,34,15,9,10,53,41,12,seriea,1996
Sampdoria,34,14,11,9,60,46,14,seriea,1996
Bologna,34,13,10,11,50,44,6,seriea,1996
Vicenza,34,12,11,11,43,38,5,seriea,1996
Fiorentina,34,10,15,9,46,41,5,seriea,1996
Atalanta BC,34,11,11,12,44,46,-2,seriea,1996
Milan,34,11,10,13,43,45,-2,seriea,1996
AS Roma,34,10,11,13,46,47,-1,seriea,1996
Napoli,34,9,14,11,38,45,-7,seriea,1996
Cagliari,34,9,10,15,45,55,-10,seriea,1996
Piacenza,34,7,16,11,29,45,-16,seriea,1996
Perugia,34,10,7,17,48,62,-14,seriea,1996
Hellas Verona,34,6,9,19,38,64,-26,seriea,1996
Reggiana,34,2,13,19,28,67,-39,seriea,1996
Juventus,34,21,11,2,67,28,39,seriea,1997
Inter,34,21,6,7,62,27,35,seriea,1997
Udinese,34,19,7,8,62,40,22,seriea,1997
AS Roma,34,16,11,7,67,42,25,seriea,1997
Fiorentina,34,15,12,7,65,36,29,seriea,1997
AC Parma,34,15,12,7,55,39,16,seriea,1997
Lazio,34,16,8,10,53,30,23,seriea,1997
Bologna,34,12,12,10,55,46,9,seriea,1997
Sampdoria,34,13,9,12,52,55,-3,seriea,1997
Milan,34,11,11,12,37,43,-6,seriea,1997
Bari,34,10,8,16,30,45,-15,seriea,1997
Piacenza,34,7,16,11,29,38,-9,seriea,1997
FC Empoli,34,10,7,17,50,58,-8,seriea,1997
Vicenza,34,9,9,16,36,61,-25,seriea,1997
Brescia,34,9,8,17,45,63,-18,seriea,1997
Atalanta BC,34,7,11,16,25,48,-23,seriea,1997
Lecce,34,6,8,20,32,72,-40,seriea,1997
Napoli,34,2,8,24,25,76,-51,seriea,1997
Milan,34,20,10,4,59,34,25,seriea,1998
Lazio,34,20,9,5,65,31,34,seriea,1998
Fiorentina,34,16,8,10,55,41,14,seriea,1998
AC Parma,34,15,10,9,55,36,19,seriea,1998
AS Roma,34,15,9,10,69,49,20,seriea,1998
Juventus,34,15,9,10,42,36,6,seriea,1998
Udinese,34,16,6,12,52,52,0,seriea,1998
Inter,34,13,7,14,59,54,5,seriea,1998
Bologna,34,11,11,12,44,47,-3,seriea,1998
Bari,34,9,15,10,39,44,-5,seriea,1998
AC Venezia 1907,34,11,9,14,38,45,-7,seriea,1998
Cagliari,34,11,8,15,49,50,-1,seriea,1998
Piacenza,34,11,8,15,48,49,-1,seriea,1998
Perugia,34,11,6,17,43,61,-18,seriea,1998
Salernitana,34,10,8,16,37,51,-14,seriea,1998
Sampdoria,34,9,10,15,38,55,-17,seriea,1998
Vicenza,34,8,9,17,27,47,-20,seriea,1998
FC Empoli,34,4,10,20,26,63,-37,seriea,1998
Lazio,34,21,9,4,64,33,31,seriea,1999
Juventus,34,21,8,5,46,20,26,seriea,1999
Milan,34,16,13,5,65,40,25,seriea,1999
Inter,34,17,7,10,58,36,22,seriea,1999
AC Parma,34,16,10,8,52,37,15,seriea,1999
AS Roma,34,14,12,8,57,34,23,seriea,1999
Fiorentina,34,13,12,9,48,38,10,seriea,1999
Udinese,34,13,11,10,55,45,10,seriea,1999
Hellas Verona,34,10,13,11,40,45,-5,seriea,1999
Perugia,34,12,6,16,36,52,-16,seriea,1999
Reggina,34,9,13,12,31,42,-11,seriea,1999
Bologna,34,9,13,12,32,39,-7,seriea,1999
Lecce,34,10,10,14,33,49,-16,seriea,1999
Bari,34,10,9,15,34,48,-14,seriea,1999
Torino,34,8,12,14,35,47,-12,seriea,1999
AC Venezia 1907,34,6,8,20,30,60,-30,seriea,1999
Cagliari,34,3,13,18,29,54,-25,seriea,1999
Piacenza,34,4,9,21,19,45,-26,seriea,1999
AS Roma,34,22,9,3,68,33,35,seriea,2000
Juventus,34,21,10,3,61,27,34,seriea,2000
Lazio,34,21,6,7,65,36,29,seriea,2000
AC Parma,34,16,8,10,51,31,20,seriea,2000
Inter,34,14,9,11,47,47,0,seriea,2000
Milan,34,12,13,9,56,46,10,seriea,2000
Atalanta BC,34,10,14,10,38,34,4,seriea,2000
Brescia,34,10,14,10,44,42,2,seriea,2000
Fiorentina,34,10,13,11,53,52,1,seriea,2000
Bologna,34,11,10,13,49,53,-4,seriea,2000
Perugia,34,10,12,12,49,53,-4,seriea,2000
Udinese,34,11,5,18,49,59,-10,seriea,2000
Lecce,34,8,13,13,40,54,-14,seriea,2000
Reggina,34,10,7,17,32,49,-17,seriea,2000
Hellas Verona,34,10,7,17,40,59,-19,seriea,2000
Vicenza,34,9,9,16,37,51,-14,seriea,2000
Napoli,34,8,12,14,35,51,-16,seriea,2000
Bari,34,5,5,24,31,68,-37,seriea,2000
Juventus,34,20,11,3,64,23,41,seriea,2001
AS Roma,34,19,13,2,58,24,34,seriea,2001
Inter,34,20,9,5,62,35,27,seriea,2001
Milan,34,14,13,7,47,33,14,seriea,2001
Chievo Verona,34,14,12,8,57,52,5,seriea,2001
Lazio,34,14,11,9,50,37,13,seriea,2001
Bologna,34,15,7,12,40,40,0,seriea,2001
Perugia,34,13,7,14,38,46,-8,seriea,2001
Atalanta BC,34,12,9,13,41,50,-9,seriea,2001
AC Parma,34,12,8,14,43,47,-4,seriea,2001
Torino,34,10,13,11,37,39,-2,seriea,2001
Piacenza,34,11,9,14,49,43,6,seriea,2001
Brescia,34,9,13,12,43,52,-9,seriea,2001
Udinese,34,11,7,16,41,52,-11,seriea,2001
Hellas Verona,34,11,6,17,41,53,-12,seriea,2001
Lecce,34,6,10,18,36,56,-20,seriea,2001
Fiorentina,34,5,7,22,29,63,-34,seriea,2001
AC Venezia 1907,34,3,9,22,30,61,-31,seriea,2001
Juventus,34,21,9,4,64,29,35,seriea,2002
Inter,34,19,8,7,64,38,26,seriea,2002
Milan,34,18,7,9,55,30,25,seriea,2002
Lazio,34,15,15,4,57,32,25,seriea,2002
AC Parma,34,15,11,8,55,36,19,seriea,2002
Udinese,34,16,8,10,38,35,3,seriea,2002
Chievo Verona,34,16,7,11,51,39,12,seriea,2002
AS Roma,34,13,10,11,55,46,9,seriea,2002
Brescia,34,9,15,10,36,38,-2,seriea,2002
Perugia,34,10,12,12,40,48,-8,seriea,2002
Bologna,34,10,11,13,39,47,-8,seriea,2002
Modena,34,9,11,14,30,48,-18,seriea,2002
FC Empoli,34,9,11,14,36,46,-10,seriea,2002
Atalanta BC,34,8,14,12,35,47,-12,seriea,2002
Reggina,34,10,8,16,38,53,-15,seriea,2002
Piacenza,34,8,6,20,44,62,-18,seriea,2002
Como,34,4,12,18,29,57,-28,seriea,2002
Torino,34,4,9,21,23,58,-35,seriea,2002
AC Milan,34,25,7,2,65,24,41,seriea,2003
AS Roma,34,21,8,5,68,19,49,seriea,2003
Juventus,34,21,6,7,67,42,25,seriea,2003
Inter,34,17,8,9,59,37,22,seriea,2003
AC Parma,34,16,10,8,57,46,11,seriea,2003
Lazio,34,16,8,10,52,38,14,seriea,2003
Udinese,34,13,11,10,44,40,4,seriea,2003
Sampdoria,34,11,13,10,40,42,-2,seriea,2003
Chievo Verona,34,11,11,12,36,37,-1,seriea,2003
Lecce,34,11,8,15,43,56,-13,seriea,2003
Brescia,34,9,13,12,52,57,-5,seriea,2003
Bologna,34,10,9,15,45,53,-8,seriea,2003
Reggina,34,6,16,12,29,45,-16,seriea,2003
AC Siena,34,8,10,16,41,54,-13,seriea,2003
Perugia,34,6,14,14,44,56,-12,seriea,2003
Modena,34,6,12,16,27,46,-19,seriea,2003
FC Empoli,34,7,9,18,26,54,-28,seriea,2003
Ancona,34,2,7,25,21,70,-49,seriea,2003
Juventus,38,26,8,4,67,27,40,seriea,2004
AC Milan,38,23,10,5,63,28,35,seriea,2004
Inter,38,18,18,2,65,37,28,seriea,2004
Udinese,38,17,11,10,56,40,16,seriea,2004
Sampdoria,38,17,10,11,42,29,13,seriea,2004
US Palermo,38,12,17,9,48,44,4,seriea,2004
Messina Peloro,38,12,12,14,44,52,-8,seriea,2004
AS Roma,38,11,12,15,55,58,-3,seriea,2004
AS Livorno,38,11,12,15,49,60,-11,seriea,2004
Reggina,38,10,14,14,36,45,-9,seriea,2004
Lecce,38,10,14,14,66,73,-7,seriea,2004
Cagliari,38,10,14,14,51,60,-9,seriea,2004
Lazio,38,11,11,16,48,53,-5,seriea,2004
AC Siena,38,9,16,13,44,55,-11,seriea,2004
Chievo Verona,38,11,10,17,32,49,-17,seriea,2004
Fiorentina,38,9,15,14,42,50,-8,seriea,2004
Bologna,38,9,15,14,33,36,-3,seriea,2004
Parma,38,10,12,16,48,65,-17,seriea,2004
Brescia,38,11,8,19,37,54,-17,seriea,2004
Atalanta BC,38,8,11,19,34,45,-11,seriea,2004
Inter,38,23,7,8,68,30,38,seriea,2005
AS Roma,38,19,12,7,70,42,28,seriea,2005
AC Milan,38,28,4,6,85,31,54,seriea,2005
Chievo Verona,38,13,15,10,54,49,5,seriea,2005
US Palermo,38,13,13,12,50,52,-2,seriea,2005
AS Livorno,38,12,13,13,37,44,-7,seriea,2005
Parma,38,12,9,17,46,60,-14,seriea,2005
FC Empoli,38,13,6,19,47,61,-14,seriea,2005
Fiorentina,38,22,8,8,66,41,25,seriea,2005
Ascoli,38,9,16,13,43,53,-10,seriea,2005
Udinese,38,11,10,17,40,54,-14,seriea,2005
Sampdoria,38,10,11,17,47,51,-4,seriea,2005
Reggina,38,11,8,19,39,65,-26,seriea,2005
Cagliari,38,8,15,15,42,55,-13,seriea,2005
AC Siena,38,9,12,17,42,60,-18,seriea,2005
Lazio,38,16,14,8,57,47,10,seriea,2005
Messina Peloro,38,6,13,19,33,59,-26,seriea,2005
Lecce,38,7,8,23,30,57,-27,seriea,2005
Treviso,38,3,12,23,24,56,-32,seriea,2005
Juventus,38,27,10,1,71,24,47,seriea,2005
Inter,38,30,7,1,80,34,46,seriea,2006
AS Roma,38,22,9,7,74,34,40,seriea,2006
Lazio,38,18,11,9,59,33,26,seriea,2006
AC Milan,38,19,12,7,57,36,21,seriea,2006
US Palermo,38,16,10,12,58,51,7,seriea,2006
Fiorentina,38,21,10,7,62,31,31,seriea,2006
FC Empoli,38,14,12,12,42,43,-1,seriea,2006
Atalanta BC,38,12,14,12,56,54,2,seriea,2006
Sampdoria,38,13,10,15,44,48,-4,seriea,2006
Udinese,38,12,10,16,49,55,-6,seriea,2006
AS Livorno,38,10,13,15,41,54,-13,seriea,2006
Parma,38,10,12,16,41,56,-15,seriea,2006
Catania,38,10,11,17,46,68,-22,seriea,2006
Reggina,38,12,15,11,52,50,2,seriea,2006
AC Siena,38,9,14,15,35,45,-10,seriea,2006
Torino,38,10,10,18,27,47,-20,seriea,2006
Cagliari,38,9,13,16,35,46,-11,seriea,2006
Chievo Verona,38,9,12,17,38,48,-10,seriea,2006
Ascoli,38,5,12,21,36,67,-31,seriea,2006
Messina Peloro,38,5,11,22,37,69,-32,seriea,2006
Inter,38,25,10,3,69,26,43,seriea,2007
AS Roma,38,24,10,4,72,37,35,seriea,2007
Juventus,38,20,12,6,72,37,35,seriea,2007
Fiorentina,38,19,9,10,55,39,16,seriea,2007
AC Milan,38,18,10,10,66,38,28,seriea,2007
Sampdoria,38,17,9,12,56,46,10,seriea,2007
Udinese,38,16,9,13,48,53,-5,seriea,2007
Napoli,38,14,8,16,50,53,-3,seriea,2007
Atalanta BC,38,12,12,14,52,56,-4,seriea,2007
Genoa,38,13,9,16,44,52,-8,seriea,2007
US Palermo,38,12,11,15,47,57,-10,seriea,2007
Lazio,38,11,13,14,47,51,-4,seriea,2007
AC Siena,38,9,17,12,40,45,-5,seriea,2007
Cagliari,38,11,9,18,40,56,-16,seriea,2007
Torino,38,8,16,14,36,49,-13,seriea,2007
Reggina,38,9,13,16,37,56,-19,seriea,2007
Catania,38,8,13,17,33,45,-12,seriea,2007
FC Empoli,38,9,9,20,29,52,-23,seriea,2007
Parma,38,7,13,18,42,62,-20,seriea,2007
AS Livorno,38,6,12,20,35,60,-25,seriea,2007
Inter,38,25,9,4,70,32,38,seriea,2008
Juventus,38,21,11,6,69,37,32,seriea,2008
AC Milan,38,22,8,8,70,35,35,seriea,2008
Fiorentina,38,21,5,12,53,38,15,seriea,2008
Genoa,38,19,11,8,56,39,17,seriea,2008
AS Roma,38,18,9,11,64,61,3,seriea,2008
Udinese,38,16,10,12,61,50,11,seriea,2008
US Palermo,38,17,6,15,57,50,7,seriea,2008
Cagliari,38,15,8,15,49,50,-1,seriea,2008
Lazio,38,15,5,18,46,55,-9,seriea,2008
Atalanta BC,38,13,8,17,45,48,-3,seriea,2008
Napoli,38,12,10,16,43,45,-2,seriea,2008
Sampdoria,38,11,13,14,49,52,-3,seriea,2008
AC Siena,38,12,8,18,33,44,-11,seriea,2008
Catania,38,12,7,19,41,51,-10,seriea,2008
Chievo Verona,38,8,14,16,35,49,-14,seriea,2008
Bologna,38,9,10,19,43,62,-19,seriea,2008
Torino,38,8,10,20,37,61,-24,seriea,2008
Reggina,38,6,13,19,30,62,-32,seriea,2008
Lecce,38,5,15,18,37,67,-30,seriea,2008
Inter,38,24,10,4,75,34,41,seriea,2009
AS Roma,38,24,8,6,68,41,27,seriea,2009
AC Milan,38,20,10,8,60,39,21,seriea,2009
Sampdoria,38,19,10,9,49,41,8,seriea,2009
US Palermo,38,18,11,9,59,47,12,seriea,2009
Napoli,38,15,14,9,50,43,7,seriea,2009
Juventus,38,16,7,15,55,56,-1,seriea,2009
Parma,38,14,10,14,46,51,-5,seriea,2009
Genoa,38,14,9,15,57,61,-4,seriea,2009
Bari,38,13,11,14,49,49,0,seriea,2009
Fiorentina,38,13,8,17,48,47,1,seriea,2009
Lazio,38,11,13,14,39,43,-4,seriea,2009
Catania,38,10,15,13,44,45,-1,seriea,2009
Chievo Verona,38,12,8,18,37,42,-5,seriea,2009
Udinese,38,11,11,16,54,59,-5,seriea,2009
Cagliari,38,11,11,16,56,58,-2,seriea,2009
Bologna,38,10,12,16,42,55,-13,seriea,2009
Atalanta BC,38,9,8,21,37,53,-16,seriea,2009
AC Siena,38,7,10,21,40,67,-27,seriea,2009
AS Livorno,38,7,8,23,27,61,-34,seriea,2009
AC Milan,38,24,10,4,65,24,41,seriea,2010
Inter,38,23,7,8,69,42,27,seriea,2010
Napoli,38,21,7,10,59,39,20,seriea,2010
Udinese,38,20,6,12,65,43,22,seriea,2010
Lazio,38,20,6,12,55,39,16,seriea,2010
AS Roma,38,18,9,11,59,52,7,seriea,2010
Juventus,38,15,13,10,57,47,10,seriea,2010
US Palermo,38,17,5,16,58,63,-5,seriea,2010
Fiorentina,38,12,15,11,49,44,5,seriea,2010
Genoa,38,14,9,15,45,47,-2,seriea,2010
Chievo Verona,38,11,13,14,38,40,-2,seriea,2010
Parma,38,11,13,14,39,47,-8,seriea,2010
Catania,38,12,10,16,40,52,-12,seriea,2010
Cagliari,38,12,9,17,44,51,-7,seriea,2010
Cesena,38,11,10,17,38,50,-12,seriea,2010
Bologna,38,11,12,15,35,52,-17,seriea,2010
Lecce,38,11,8,19,46,66,-20,seriea,2010
Sampdoria,38,8,12,18,33,49,-16,seriea,2010
Brescia,38,7,11,20,34,52,-18,seriea,2010
Bari,38,5,9,24,27,56,-29,seriea,2010
Juventus,38,23,15,0,68,20,48,seriea,2011
AC Milan,38,24,8,6,74,33,41,seriea,2011
Udinese,38,18,10,10,52,35,17,seriea,2011
Lazio,38,18,8,12,56,47,9,seriea,2011
Napoli,38,16,13,9,66,46,20,seriea,2011
Inter,38,17,7,14,58,55,3,seriea,2011
AS Roma,38,16,8,14,60,54,6,seriea,2011
Parma,38,15,11,12,54,53,1,seriea,2011
Bologna,38,13,12,13,41,43,-2,seriea,2011
Chievo Verona,38,12,13,13,35,45,-10,seriea,2011
Catania,38,11,15,12,47,52,-5,seriea,2011
Atalanta BC,38,13,13,12,41,43,-2,seriea,2011
Fiorentina,38,11,13,14,37,43,-6,seriea,2011
AC Siena,38,11,11,16,45,45,0,seriea,2011
Cagliari,38,10,13,15,37,46,-9,seriea,2011
US Palermo,38,11,10,17,52,62,-10,seriea,2011
Genoa,38,11,9,18,50,69,-19,seriea,2011
Lecce,38,8,12,18,40,56,-16,seriea,2011
Novara,38,7,11,20,35,65,-30,seriea,2011
Cesena,38,4,10,24,24,60,-36,seriea,2011
Juventus,38,27,6,5,71,24,47,seriea,2012
Napoli,38,23,9,6,73,36,37,seriea,2012
AC Milan,38,21,9,8,67,39,28,seriea,2012
Fiorentina,38,21,7,10,72,44,28,seriea,2012
Udinese,38,18,12,8,59,45,14,seriea,2012
AS Roma,38,18,8,12,71,56,15,seriea,2012
Lazio,38,18,7,13,51,42,9,seriea,2012
Catania,38,15,11,12,50,46,4,seriea,2012
Inter,38,16,6,16,55,57,-2,seriea,2012
Parma,38,13,10,15,45,46,-1,seriea,2012
Cagliari,38,12,11,15,43,55,-12,seriea,2012
Chievo Verona,38,12,9,17,37,52,-15,seriea,2012
Bologna,38,11,11,16,46,52,-6,seriea,2012
Sampdoria,38,11,10,17,43,51,-8,seriea,2012
Atalanta BC,38,11,9,18,39,56,-17,seriea,2012
Torino,38,8,16,14,46,55,-9,seriea,2012
Genoa,38,8,14,16,38,52,-14,seriea,2012
US Palermo,38,6,14,18,34,54,-20,seriea,2012
AC Siena,38,9,9,20,36,57,-21,seriea,2012
Pescara,38,6,4,28,27,84,-57,seriea,2012
Juventus,38,33,3,2,80,23,57,seriea,2013
AS Roma,38,26,7,5,72,25,47,seriea,2013
Napoli,38,23,9,6,77,39,38,seriea,2013
Fiorentina,38,19,8,11,65,44,21,seriea,2013
Inter,38,15,15,8,62,39,23,seriea,2013
Parma,38,15,13,10,58,46,12,seriea,2013
Torino,38,15,12,11,58,48,10,seriea,2013
AC Milan,38,16,9,13,57,49,8,seriea,2013
Lazio,38,15,11,12,54,54,0,seriea,2013
Hellas Verona,38,16,6,16,62,68,-6,seriea,2013
Atalanta BC,38,15,5,18,43,51,-8,seriea,2013
Sampdoria,38,12,9,17,48,62,-14,seriea,2013
Udinese,38,12,8,18,46,57,-11,seriea,2013
Genoa,38,11,11,16,41,50,-9,seriea,2013
Cagliari,38,9,12,17,34,53,-19,seriea,2013
Chievo Verona,38,10,6,22,34,54,-20,seriea,2013
Sassuolo,38,9,7,22,43,72,-29,seriea,2013
Catania,38,8,8,22,34,66,-32,seriea,2013
Bologna,38,5,14,19,28,58,-30,seriea,2013
AS Livorno,38,6,7,25,39,77,-38,seriea,2013
Juventus,38,26,9,3,72,24,48,seriea,2014
AS Roma,38,19,13,6,54,31,23,seriea,2014
Lazio,38,21,6,11,71,38,33,seriea,2014
Fiorentina,38,18,10,10,61,46,15,seriea,2014
Napoli,38,18,9,11,70,54,16,seriea,2014
Genoa,38,16,11,11,62,47,15,seriea,2014
Sampdoria,38,13,17,8,48,42,6,seriea,2014
Inter,38,14,13,11,59,48,11,seriea,2014
Torino,38,14,12,12,48,45,3,seriea,2014
AC Milan,38,13,13,12,56,50,6,seriea,2014
US Palermo,38,12,13,13,53,55,-2,seriea,2014
Sassuolo,38,12,13,13,49,57,-8,seriea,2014
Hellas Verona,38,11,13,14,49,65,-16,seriea,2014
Chievo Verona,38,10,13,15,28,41,-13,seriea,2014
FC Empoli,38,8,18,12,46,52,-6,seriea,2014
Udinese,38,10,11,17,43,56,-13,seriea,2014
Atalanta BC,38,7,16,15,38,57,-19,seriea,2014
Cagliari,38,8,10,20,48,68,-20,seriea,2014
Cesena,38,4,12,22,36,73,-37,seriea,2014
Parma,38,6,8,24,33,75,-42,seriea,2014
Juventus,38,29,4,5,75,20,55,seriea,2015
Napoli,38,25,7,6,80,32,48,seriea,2015
AS Roma,38,23,11,4,83,41,42,seriea,2015
Inter,38,20,7,11,50,38,12,seriea,2015
Fiorentina,38,18,10,10,60,42,18,seriea,2015
Sassuolo,38,16,13,9,49,40,9,seriea,2015
AC Milan,38,15,12,11,49,43,6,seriea,2015
Lazio,38,15,9,14,52,52,0,seriea,2015
Chievo Verona,38,13,11,14,43,45,-2,seriea,2015
Genoa,38,13,7,18,45,48,-3,seriea,2015
FC Empoli,38,12,10,16,40,49,-9,seriea,2015
Torino,38,12,9,17,52,55,-3,seriea,2015
Atalanta BC,38,11,12,15,41,47,-6,seriea,2015
Bologna,38,11,9,18,33,45,-12,seriea,2015
Sampdoria,38,10,10,18,48,61,-13,seriea,2015
US Palermo,38,10,9,19,38,65,-27,seriea,2015
Udinese,38,10,9,19,35,60,-25,seriea,2015
Carpi,38,9,11,18,37,57,-20,seriea,2015
Frosinone,38,8,7,23,35,76,-41,seriea,2015
Hellas Verona,38,5,13,20,34,63,-29,seriea,2015
Juventus,38,29,4,5,77,27,50,seriea,2016
AS Roma,38,28,3,7,90,38,52,seriea,2016
Napoli,38,26,8,4,94,39,55,seriea,2016
Atalanta BC,38,21,9,8,62,41,21,seriea,2016
Lazio,38,21,7,10,74,51,23,seriea,2016
AC Milan,38,18,9,11,57,45,12,seriea,2016
Inter,38,19,5,14,72,49,23,seriea,2016
Fiorentina,38,16,12,10,63,57,6,seriea,2016
Torino,38,13,14,11,71,66,5,seriea,2016
Sampdoria,38,12,12,14,49,55,-6,seriea,2016
Cagliari,38,14,5,19,55,76,-21,seriea,2016
Sassuolo,38,13,7,18,58,63,-5,seriea,2016
Udinese,38,12,9,17,47,56,-9,seriea,2016
Chievo Verona,38,12,7,19,43,61,-18,seriea,2016
Bologna,38,11,8,19,40,58,-18,seriea,2016
Genoa,38,9,9,20,38,64,-26,seriea,2016
Crotone,38,9,7,22,34,58,-24,seriea,2016
FC Empoli,38,8,8,22,29,61,-32,seriea,2016
US Palermo,38,6,8,24,33,77,-44,seriea,2016
Pescara,38,3,9,26,37,81,-44,seriea,2016
Juventus,38,30,5,3,86,24,62,seriea,2017
Napoli,38,28,7,3,77,29,48,seriea,2017
AS Roma,38,23,8,7,61,28,33,seriea,2017
Inter,38,20,12,6,66,30,36,seriea,2017
Lazio,38,21,9,8,89,49,40,seriea,2017
AC Milan,38,18,10,10,56,42,14,seriea,2017
Atalanta BC,38,16,12,10,57,39,18,seriea,2017
Fiorentina,38,16,9,13,54,46,8,seriea,2017
Torino,38,13,15,10,54,46,8,seriea,2017
Sampdoria,38,16,6,16,56,60,-4,seriea,2017
Sassuolo,38,11,10,17,29,59,-30,seriea,2017
Genoa,38,11,8,19,33,43,-10,seriea,2017
Chievo Verona,38,10,10,18,36,59,-23,seriea,2017
Udinese,38,12,4,22,48,63,-15,seriea,2017
Bologna,38,11,6,21,40,52,-12,seriea,2017
Cagliari,38,11,6,21,33,61,-28,seriea,2017
SPAL,38,8,14,16,39,59,-20,seriea,2017
Crotone,38,9,8,21,40,66,-26,seriea,2017
Hellas Verona,38,7,4,27,30,78,-48,seriea,2017
Benevento,38,6,3,29,33,84,-51,seriea,2017
Juventus,38,28,6,4,70,30,40,seriea,2018
Napoli,38,24,7,7,74,36,38,seriea,2018
Atalanta BC,38,20,9,9,77,46,31,seriea,2018
Inter,38,20,9,9,57,33,24,seriea,2018
AC Milan,38,19,11,8,55,36,19,seriea,2018
AS Roma,38,18,12,8,66,48,18,seriea,2018
Torino,38,16,15,7,52,37,15,seriea,2018
Lazio,38,17,8,13,56,46,10,seriea,2018
Sampdoria,38,15,8,15,60,51,9,seriea,2018
Bologna,38,11,11,16,48,56,-8,seriea,2018
Sassuolo,38,9,16,13,53,60,-7,seriea,2018
Udinese,38,11,10,17,39,53,-14,seriea,2018
SPAL,38,11,9,18,44,56,-12,seriea,2018
Parma,38,10,11,17,41,61,-20,seriea,2018
Cagliari,38,10,11,17,36,54,-18,seriea,2018
Fiorentina,38,8,17,13,47,45,2,seriea,2018
Genoa,38,8,14,16,39,57,-18,seriea,2018
FC Empoli,38,10,8,20,51,70,-19,seriea,2018
Frosinone,38,5,10,23,29,69,-40,seriea,2018
Chievo Verona,38,2,14,22,25,75,-50,seriea,2018
Juventus,38,26,5,7,76,43,33,seriea,2019
Inter,38,24,10,4,81,36,45,seriea,2019
Atalanta BC,38,23,9,6,98,48,50,seriea,2019
Lazio,38,24,6,8,79,42,37,seriea,2019
AS Roma,38,21,7,10,77,51,26,seriea,2019
AC Milan,38,19,9,10,63,46,17,seriea,2019
Napoli,38,18,8,12,61,50,11,seriea,2019
Sassuolo,38,14,9,15,69,63,6,seriea,2019
Hellas Verona,38,12,13,13,47,51,-4,seriea,2019
Fiorentina,38,12,13,13,51,48,3,seriea,2019
Parma,38,14,7,17,56,57,-1,seriea,2019
Bologna,38,12,11,15,52,65,-13,seriea,2019
Udinese,38,12,9,17,37,51,-14,seriea,2019
Cagliari,38,11,12,15,52,56,-4,seriea,2019
Sampdoria,38,12,6,20,48,65,-17,seriea,2019
Torino,38,11,7,20,46,68,-22,seriea,2019
Genoa,38,10,9,19,47,73,-26,seriea,2019
Lecce,38,9,8,21,52,85,-33,seriea,2019
Brescia,38,6,7,25,35,79,-44,seriea,2019
SPAL,38,5,5,28,27,77,-50,seriea,2019
Inter,38,28,7,3,89,35,54,seriea,2020
AC Milan,38,24,7,7,74,41,33,seriea,2020
Atalanta BC,38,23,9,6,90,47,43,seriea,2020
Juventus,38,23,9,6,77,38,39,seriea,2020
Napoli,38,24,5,9,86,41,45,seriea,2020
Lazio,38,21,5,12,61,55,6,seriea,2020
AS Roma,38,18,8,12,68,58,10,seriea,2020
Sassuolo,38,17,11,10,64,56,8,seriea,2020
Sampdoria,38,15,7,16,52,54,-2,seriea,2020
Hellas Verona,38,11,12,15,46,48,-2,seriea,2020
Genoa,38,10,12,16,47,58,-11,seriea,2020
Bologna,38,10,11,17,51,65,-14,seriea,2020
Fiorentina,38,9,13,16,47,59,-12,seriea,2020
Udinese,38,10,10,18,42,58,-16,seriea,2020
Spezia Calcio,38,9,12,17,52,72,-20,seriea,2020
Cagliari,38,9,10,19,43,59,-16,seriea,2020
Torino,38,7,16,15,50,69,-19,seriea,2020
Benevento,38,7,12,19,40,75,-35,seriea,2020
Crotone,38,6,5,27,45,92,-47,seriea,2020
Parma,38,3,11,24,39,83,-44,seriea,2020
AC Milan,38,26,8,4,69,31,38,seriea,2021
Inter,38,25,9,4,84,32,52,seriea,2021
Napoli,38,24,7,7,74,31,43,seriea,2021
Juventus,38,20,10,8,57,37,20,seriea,2021
Lazio,38,18,10,10,77,58,19,seriea,2021
AS Roma,38,18,9,11,59,43,16,seriea,2021
Fiorentina,38,19,5,14,59,51,8,seriea,2021
Atalanta BC,38,16,11,11,65,48,17,seriea,2021
Hellas Verona,38,14,11,13,65,59,6,seriea,2021
Torino,38,13,11,14,46,41,5,seriea,2021
Sassuolo,38,13,11,14,64,66,-2,seriea,2021
Udinese,38,11,14,13,61,58,3,seriea,2021
Bologna,38,12,10,16,44,55,-11,seriea,2021
FC Empoli,38,10,11,17,50,70,-20,seriea,2021
Sampdoria,38,10,6,22,46,63,-17,seriea,2021
Spezia Calcio,38,10,6,22,41,71,-30,seriea,2021
Salernitana,38,7,10,21,33,78,-45,seriea,2021
Cagliari,38,6,12,20,34,68,-34,seriea,2021
Genoa,38,4,16,18,27,60,-33,seriea,2021
Venezia,38,6,9,23,34,69,-35,seriea,2021
Napoli,38,28,6,4,77,28,49,seriea,2022
Lazio,38,22,8,8,60,30,30,seriea,2022
Inter,38,23,3,12,71,42,29,seriea,2022
AC Milan,38,20,10,8,64,43,21,seriea,2022
Atalanta BC,38,19,7,12,66,48,18,seriea,2022
AS Roma,38,18,9,11,50,38,12,seriea,2022
Juventus,38,22,6,10,56,33,23,seriea,2022
Fiorentina,38,15,11,12,53,43,10,seriea,2022
Bologna,38,14,12,12,53,49,4,seriea,2022
Torino,38,14,11,13,42,41,1,seriea,2022
Monza,38,14,10,14,48,52,-4,seriea,2022
Udinese,38,11,13,14,47,48,-1,seriea,2022
Sassuolo,38,12,9,17,47,61,-14,seriea,2022
FC Empoli,38,10,13,15,37,49,-12,seriea,2022
Salernitana,38,9,15,14,48,62,-14,seriea,2022
Lecce,38,8,12,18,33,46,-13,seriea,2022
Spezia Calcio,38,6,13,19,31,62,-31,seriea,2022
Hellas Verona,38,7,10,21,31,59,-28,seriea,2022
Cremonese,38,5,12,21,36,69,-33,seriea,2022
Sampdoria,38,3,10,25,24,71,-47,seriea,2022
Inter,38,29,7,2,89,22,67,seriea,2023
AC Milan,38,22,9,7,76,49,27,seriea,2023
Juventus,38,19,14,5,54,31,23,seriea,2023
Atalanta BC,38,21,6,11,72,42,30,seriea,2023
Bologna,38,18,14,6,54,32,22,seriea,2023
AS Roma,38,18,9,11,65,46,19,seriea,2023
Lazio,38,18,7,13,49,39,10,seriea,2023
Fiorentina,38,17,9,12,61,46,15,seriea,2023
Torino,38,13,14,11,36,36,0,seriea,2023
Napoli,38,13,14,11,55,48,7,seriea,2023
Genoa,38,12,13,13,45,45,0,seriea,2023
Monza,38,11,12,15,39,51,-12,seriea,2023
Hellas Verona,38,9,11,18,38,51,-13,seriea,2023
Lecce,38,8,14,16,32,54,-22,seriea,2023
Udinese,38,6,19,13,37,53,-16,seriea,2023
Cagliari,38,8,12,18,42,68,-26,seriea,2023
FC Empoli,38,9,9,20,29,54,-25,seriea,2023
Frosinone,38,8,11,19,44,69,-25,seriea,2023
Sassuolo,38,7,9,22,43,75,-32,seriea,2023
Salernitana,38,2,11,25,32,81,-49,seriea,2023
Inter,31,20,8,3,69,30,39,seriea,2024
Napoli,31,19,8,4,48,25,23,seriea,2024
Atalanta BC,31,17,7,7,63,30,33,seriea,2024
Bologna,31,15,12,4,51,35,16,seriea,2024
Juventus,31,14,14,3,47,29,18,seriea,2024
Lazio,31,16,7,8,52,42,10,seriea,2024
AS Roma,31,15,8,8,46,31,15,seriea,2024
Fiorentina,31,15,7,9,49,32,17,seriea,2024
AC Milan,32,14,9,9,51,37,14,seriea,2024
Torino,31,9,13,9,36,36,0,seriea,2024
Udinese,32,11,7,14,36,46,-10,seriea,2024
Genoa,31,9,11,11,29,38,-9,seriea,2024
Como,31,8,9,14,39,48,-9,seriea,2024
Hellas Verona,31,9,4,18,30,59,-29,seriea,2024
Cagliari,31,7,9,15,31,44,-13,seriea,2024
Parma,31,5,12,14,37,51,-14,seriea,2024
Lecce,31,6,8,17,22,50,-28,seriea,2024
FC Empoli,31,4,12,15,24,47,-23,seriea,2024
Venezia,31,3,12,16,24,44,-20,seriea,2024
Monza,31,2,9,20,25,55,-30,seriea,2024
Marseille,38,22,10,6,71,36,35,ligue1,1992
Paris SG,38,20,11,7,61,29,32,ligue1,1992
Monaco,38,21,9,8,56,29,27,ligue1,1992
G. Bordeaux,38,18,12,8,42,25,17,ligue1,1992
FC Nantes,38,17,11,10,54,39,15,ligue1,1992
AJ Auxerre,38,18,7,13,57,44,13,ligue1,1992
Saint-Étienne,38,13,17,8,34,26,8,ligue1,1992
R. Strasbourg,38,12,16,10,58,57,1,ligue1,1992
Lens,38,12,16,10,36,41,-5,ligue1,1992
Montpellier,38,12,12,14,36,41,-5,ligue1,1992
SM Caen,38,13,9,16,55,54,1,ligue1,1992
FC Metz,38,11,13,14,44,45,-1,ligue1,1992
Toulouse,38,9,16,13,36,45,-9,ligue1,1992
Olympique Lyon,38,9,15,14,40,45,-5,ligue1,1992
Le Havre AC,38,11,11,16,42,53,-11,ligue1,1992
FC Sochaux,38,11,10,17,33,50,-17,ligue1,1992
US Valenciennes,38,9,12,17,42,56,-14,ligue1,1992
LOSC Lille,38,7,16,15,26,48,-22,ligue1,1992
SC Toulon Var,38,6,13,19,31,57,-26,ligue1,1992
Nîmes Olympique,38,3,16,19,32,66,-34,ligue1,1992
Paris SG,38,24,11,3,54,22,32,ligue1,1993
Marseille,38,19,13,6,56,33,23,ligue1,1993
AJ Auxerre,38,18,10,10,54,29,25,ligue1,1993
G. Bordeaux,38,19,8,11,54,37,17,ligue1,1993
FC Nantes,38,17,11,10,47,32,15,ligue1,1993
Cannes,38,16,12,10,50,43,7,ligue1,1993
Montpellier,38,15,13,10,41,37,4,ligue1,1993
Olympique Lyon,38,17,8,13,38,40,-2,ligue1,1993
Monaco,38,14,13,11,52,36,16,ligue1,1993
Lens,38,13,13,12,49,40,9,ligue1,1993
Saint-Étienne,38,12,13,13,38,36,2,ligue1,1993
FC Metz,38,12,13,13,36,35,1,ligue1,1993
R. Strasbourg,38,10,14,14,43,47,-4,ligue1,1993
FC Sochaux,38,10,13,15,39,48,-9,ligue1,1993
LOSC Lille,38,8,16,14,41,52,-11,ligue1,1993
SM Caen,38,12,7,19,29,54,-25,ligue1,1993
Le Havre AC,38,7,15,16,29,48,-19,ligue1,1993
FC Martigues,38,5,17,16,37,58,-21,ligue1,1993
Toulouse,38,4,15,19,26,60,-34,ligue1,1993
Angers SCO,38,4,13,21,37,63,-26,ligue1,1993
FC Nantes,38,21,16,1,71,34,37,ligue1,1994
Olympique Lyon,38,19,12,7,56,38,18,ligue1,1994
Paris SG,38,20,7,11,58,41,17,ligue1,1994
AJ Auxerre,38,15,17,6,59,34,25,ligue1,1994
Lens,38,15,14,9,48,44,4,ligue1,1994
Monaco,38,15,12,11,60,39,21,ligue1,1994
G. Bordeaux,38,16,9,13,52,47,5,ligue1,1994
FC Metz,38,16,8,14,50,44,6,ligue1,1994
Cannes,38,15,8,15,56,48,8,ligue1,1994
R. Strasbourg,38,13,12,13,43,43,0,ligue1,1994
FC Martigues,38,13,12,13,37,49,-12,ligue1,1994
Le Havre AC,38,12,13,13,46,49,-3,ligue1,1994
Stade Rennais,38,12,12,14,53,55,-2,ligue1,1994
LOSC Lille,38,13,9,16,29,44,-15,ligue1,1994
SC Bastia,38,11,11,16,44,56,-12,ligue1,1994
OGC Nice,38,11,10,17,39,52,-13,ligue1,1994
Montpellier,38,9,14,15,38,53,-15,ligue1,1994
Saint-Étienne,38,9,11,18,45,55,-10,ligue1,1994
SM Caen,38,10,6,22,38,58,-20,ligue1,1994
FC Sochaux,38,6,5,27,29,68,-39,ligue1,1994
AJ Auxerre,38,22,6,10,66,30,36,ligue1,1995
Paris SG,38,19,11,8,65,36,29,ligue1,1995
Monaco,38,19,11,8,64,39,25,ligue1,1995
FC Metz,38,18,11,9,42,30,12,ligue1,1995
Lens,38,16,15,7,45,31,14,ligue1,1995
Montpellier,38,17,9,12,51,40,11,ligue1,1995
FC Nantes,38,14,13,11,44,42,2,ligue1,1995
Stade Rennais,38,13,15,10,44,41,3,ligue1,1995
R. Strasbourg,38,14,12,12,46,44,2,ligue1,1995
Guingamp,38,13,14,11,34,33,1,ligue1,1995
Olympique Lyon,38,10,18,10,41,41,0,ligue1,1995
OGC Nice,38,12,9,17,37,44,-7,ligue1,1995
Le Havre AC,38,11,12,15,33,45,-12,ligue1,1995
Cannes,38,12,8,18,45,51,-6,ligue1,1995
SC Bastia,38,12,8,18,45,55,-10,ligue1,1995
G. Bordeaux,38,11,9,18,44,52,-8,ligue1,1995
LOSC Lille,38,9,12,17,27,50,-23,ligue1,1995
FC Gueugnon,38,8,14,16,27,46,-19,ligue1,1995
Saint-Étienne,38,6,16,16,36,59,-23,ligue1,1995
FC Martigues,38,9,7,22,31,58,-27,ligue1,1995
Monaco,38,23,10,5,69,30,39,ligue1,1996
Paris SG,38,18,13,7,57,31,26,ligue1,1996
FC Nantes,38,16,16,6,61,32,29,ligue1,1996
G. Bordeaux,38,16,15,7,59,42,17,ligue1,1996
FC Metz,38,17,11,10,40,30,10,ligue1,1996
AJ Auxerre,38,17,10,11,49,32,17,ligue1,1996
SC Bastia,38,17,10,11,54,47,7,ligue1,1996
Olympique Lyon,38,16,12,10,59,50,9,ligue1,1996
R. Strasbourg,38,19,3,16,52,49,3,ligue1,1996
Montpellier,38,12,15,11,40,40,0,ligue1,1996
Marseille,38,12,13,13,43,48,-5,ligue1,1996
Guingamp,38,11,13,14,32,36,-4,ligue1,1996
Lens,38,12,9,17,40,52,-12,ligue1,1996
Le Havre AC,38,10,13,15,34,43,-9,ligue1,1996
Cannes,38,9,14,15,25,41,-16,ligue1,1996
Stade Rennais,38,10,10,18,40,58,-18,ligue1,1996
SM Caen,38,7,16,15,35,46,-11,ligue1,1996
AS Nancy,38,9,10,19,33,51,-18,ligue1,1996
LOSC Lille,38,8,11,19,32,58,-26,ligue1,1996
OGC Nice,38,5,8,25,30,68,-38,ligue1,1996
Lens,34,21,5,8,55,30,25,ligue1,1997
FC Metz,34,20,8,6,48,28,20,ligue1,1997
Monaco,34,18,5,11,51,33,18,ligue1,1997
Marseille,34,16,9,9,47,27,20,ligue1,1997
G. Bordeaux,34,15,11,8,49,41,8,ligue1,1997
Olympique Lyon,34,16,5,13,39,37,2,ligue1,1997
AJ Auxerre,34,14,9,11,55,45,10,ligue1,1997
Paris SG,34,14,8,12,43,35,8,ligue1,1997
SC Bastia,34,13,11,10,36,31,5,ligue1,1997
Le Havre AC,34,10,14,10,38,35,3,ligue1,1997
FC Nantes,34,11,8,15,35,41,-6,ligue1,1997
Montpellier,34,10,11,13,32,42,-10,ligue1,1997
R. Strasbourg,34,9,10,15,39,43,-4,ligue1,1997
Stade Rennais,34,9,9,16,36,48,-12,ligue1,1997
Toulouse,34,9,9,16,26,46,-20,ligue1,1997
Guingamp,34,9,8,17,30,42,-12,ligue1,1997
LB Châteauroux,34,8,7,19,31,59,-28,ligue1,1997
Cannes,34,7,7,20,32,59,-27,ligue1,1997
G. Bordeaux,34,22,6,6,66,29,37,ligue1,1998
Marseille,34,21,8,5,56,28,28,ligue1,1998
Olympique Lyon,34,18,9,7,51,31,20,ligue1,1998
Monaco,34,18,8,8,52,32,20,ligue1,1998
Stade Rennais,34,17,8,9,45,38,7,ligue1,1998
Lens,34,14,7,13,46,43,3,ligue1,1998
FC Nantes,34,12,12,10,40,34,6,ligue1,1998
Montpellier,34,11,10,13,53,50,3,ligue1,1998
Paris SG,34,10,9,15,34,35,-1,ligue1,1998
FC Metz,34,9,12,13,28,37,-9,ligue1,1998
AS Nancy,34,10,9,15,35,45,-10,ligue1,1998
R. Strasbourg,34,8,14,12,30,36,-6,ligue1,1998
SC Bastia,34,10,8,16,37,46,-9,ligue1,1998
AJ Auxerre,34,9,10,15,40,45,-5,ligue1,1998
Le Havre AC,34,8,11,15,23,38,-15,ligue1,1998
FC Lorient,34,8,11,15,33,49,-16,ligue1,1998
FC Sochaux,34,6,15,13,30,54,-24,ligue1,1998
Toulouse,34,6,11,17,24,53,-29,ligue1,1998
Monaco,34,20,5,9,69,38,31,ligue1,1999
Paris SG,34,16,10,8,54,40,14,ligue1,1999
Olympique Lyon,34,16,8,10,45,42,3,ligue1,1999
G. Bordeaux,34,15,9,10,52,40,12,ligue1,1999
Lens,34,14,7,13,42,41,1,ligue1,1999
Saint-Étienne,34,13,9,12,46,47,-1,ligue1,1999
CS Sedan,34,13,9,12,43,44,-1,ligue1,1999
AJ Auxerre,34,13,8,13,37,39,-2,ligue1,1999
R. Strasbourg,34,13,7,14,42,52,-10,ligue1,1999
SC Bastia,34,11,12,11,43,39,4,ligue1,1999
FC Metz,34,9,17,8,38,33,5,ligue1,1999
FC Nantes,34,12,7,15,39,40,-1,ligue1,1999
Stade Rennais,34,12,7,15,44,48,-4,ligue1,1999
Troyes,34,13,4,17,36,52,-16,ligue1,1999
Marseille,34,9,15,10,45,45,0,ligue1,1999
AS Nancy,34,11,9,14,43,45,-2,ligue1,1999
Le Havre AC,34,9,7,18,30,52,-22,ligue1,1999
Montpellier,34,7,10,17,39,50,-11,ligue1,1999
FC Nantes,34,21,5,8,58,36,22,ligue1,2000
Olympique Lyon,34,17,13,4,57,30,27,ligue1,2000
LOSC Lille,34,16,11,7,43,27,16,ligue1,2000
G. Bordeaux,34,15,12,7,48,33,15,ligue1,2000
CS Sedan,34,14,10,10,47,40,7,ligue1,2000
Stade Rennais,34,15,5,14,46,37,9,ligue1,2000
Troyes,34,11,13,10,45,47,-2,ligue1,2000
SC Bastia,34,13,6,15,45,41,4,ligue1,2000
Paris SG,34,12,8,14,44,45,-1,ligue1,2000
Guingamp,34,11,11,12,40,48,-8,ligue1,2000
Monaco,34,12,7,15,53,50,3,ligue1,2000
FC Metz,34,11,9,14,35,44,-9,ligue1,2000
AJ Auxerre,34,11,8,15,31,41,-10,ligue1,2000
Lens,34,9,13,12,37,39,-2,ligue1,2000
Marseille,34,11,7,16,31,40,-9,ligue1,2000
Saint-Étienne,34,9,10,15,43,56,-13,ligue1,2000
Toulouse,34,8,10,16,34,50,-16,ligue1,2000
R. Strasbourg,34,7,8,19,28,61,-33,ligue1,2000
Olympique Lyon,34,20,6,8,62,32,30,ligue1,2001
Lens,34,18,10,6,55,30,25,ligue1,2001
AJ Auxerre,34,16,11,7,48,38,10,ligue1,2001
Paris SG,34,15,13,6,43,24,19,ligue1,2001
LOSC Lille,34,15,11,8,39,32,7,ligue1,2001
G. Bordeaux,34,14,8,12,34,31,3,ligue1,2001
Troyes,34,13,8,13,40,35,5,ligue1,2001
FC Sochaux,34,12,10,12,41,40,1,ligue1,2001
Marseille,34,11,11,12,34,39,-5,ligue1,2001
FC Nantes,34,12,7,15,35,41,-6,ligue1,2001
SC Bastia,34,12,5,17,38,44,-6,ligue1,2001
Stade Rennais,34,11,8,15,40,51,-11,ligue1,2001
Montpellier,34,9,13,12,28,31,-3,ligue1,2001
CS Sedan,34,8,15,11,35,39,-4,ligue1,2001
Monaco,34,9,12,13,36,41,-5,ligue1,2001
Guingamp,34,9,8,17,34,57,-23,ligue1,2001
FC Metz,34,9,6,19,31,47,-16,ligue1,2001
FC Lorient,34,7,10,17,43,64,-21,ligue1,2001
Olympique Lyon,38,19,11,8,63,41,22,ligue1,2002
Monaco,38,19,10,9,66,33,33,ligue1,2002
Marseille,38,19,8,11,41,36,5,ligue1,2002
G. Bordeaux,38,18,10,10,57,36,21,ligue1,2002
FC Sochaux,38,17,13,8,46,31,15,ligue1,2002
AJ Auxerre,38,18,10,10,38,29,9,ligue1,2002
Guingamp,38,19,5,14,59,46,13,ligue1,2002
Lens,38,14,15,9,43,31,12,ligue1,2002
FC Nantes,38,16,8,14,37,39,-2,ligue1,2002
OGC Nice,38,13,16,9,39,31,8,ligue1,2002
Paris SG,38,14,12,12,47,36,11,ligue1,2002
SC Bastia,38,12,11,15,40,48,-8,ligue1,2002
R. Strasbourg,38,11,12,15,40,54,-14,ligue1,2002
LOSC Lille,38,10,12,16,29,44,-15,ligue1,2002
Stade Rennais,38,10,10,18,35,45,-10,ligue1,2002
Montpellier,38,10,10,18,37,54,-17,ligue1,2002
AC Ajaccio,38,9,12,17,29,49,-20,ligue1,2002
Le Havre AC,38,10,8,20,27,47,-20,ligue1,2002
CS Sedan,38,9,9,20,41,59,-18,ligue1,2002
Troyes,38,7,10,21,23,48,-25,ligue1,2002
Olympique Lyon,38,24,7,7,64,26,38,ligue1,2003
Paris SG,38,22,10,6,50,28,22,ligue1,2003
Monaco,38,21,12,5,59,30,29,ligue1,2003
AJ Auxerre,38,19,8,11,60,34,26,ligue1,2003
FC Sochaux,38,18,9,11,54,42,12,ligue1,2003
FC Nantes,38,17,9,12,47,35,12,ligue1,2003
Marseille,38,17,6,15,51,45,6,ligue1,2003
Lens,38,15,8,15,34,48,-14,ligue1,2003
Stade Rennais,38,14,10,14,56,44,12,ligue1,2003
LOSC Lille,38,14,9,15,41,41,0,ligue1,2003
OGC Nice,38,11,17,10,42,39,3,ligue1,2003
G. Bordeaux,38,13,11,14,40,43,-3,ligue1,2003
R. Strasbourg,38,10,13,15,43,50,-7,ligue1,2003
FC Metz,38,11,9,18,34,42,-8,ligue1,2003
AC Ajaccio,38,10,10,18,33,55,-22,ligue1,2003
Toulouse,38,9,12,17,31,44,-13,ligue1,2003
SC Bastia,38,9,12,17,33,49,-16,ligue1,2003
Guingamp,38,10,8,20,36,58,-22,ligue1,2003
Le Mans UC 72,38,9,11,18,35,57,-22,ligue1,2003
Montpellier,38,8,7,23,41,74,-33,ligue1,2003
Olympique Lyon,38,22,13,3,56,22,34,ligue1,2004
LOSC Lille,38,18,13,7,52,29,23,ligue1,2004
Monaco,38,15,18,5,52,35,17,ligue1,2004
Stade Rennais,38,15,10,13,49,42,7,ligue1,2004
Marseille,38,15,10,13,47,42,5,ligue1,2004
Saint-Étienne,38,12,17,9,47,34,13,ligue1,2004
Lens,38,13,13,12,45,39,6,ligue1,2004
AJ Auxerre,38,14,10,14,48,47,1,ligue1,2004
Paris SG,38,12,15,11,40,41,-1,ligue1,2004
FC Sochaux,38,13,11,14,42,41,1,ligue1,2004
R. Strasbourg,38,12,12,14,42,43,-1,ligue1,2004
OGC Nice,38,10,16,12,38,45,-7,ligue1,2004
Toulouse,38,12,10,16,36,43,-7,ligue1,2004
AC Ajaccio,38,10,15,13,36,40,-4,ligue1,2004
G. Bordeaux,38,8,20,10,37,41,-4,ligue1,2004
FC Metz,38,10,14,14,33,45,-12,ligue1,2004
FC Nantes,38,10,13,15,33,38,-5,ligue1,2004
SM Caen,38,10,12,16,36,60,-24,ligue1,2004
SC Bastia,38,11,8,19,32,48,-16,ligue1,2004
FC Istres,38,6,14,18,25,51,-26,ligue1,2004
Olympique Lyon,38,25,9,4,73,31,42,ligue1,2005
G. Bordeaux,38,18,15,5,43,25,18,ligue1,2005
LOSC Lille,38,16,14,8,56,31,25,ligue1,2005
Lens,38,14,18,6,48,34,14,ligue1,2005
Marseille,38,16,12,10,44,35,9,ligue1,2005
AJ Auxerre,38,17,8,13,50,39,11,ligue1,2005
Stade Rennais,38,18,5,15,48,49,-1,ligue1,2005
OGC Nice,38,16,10,12,36,31,5,ligue1,2005
Paris SG,38,13,13,12,44,38,6,ligue1,2005
Monaco,38,13,13,12,42,36,6,ligue1,2005
Le Mans UC 72,38,13,13,12,33,36,-3,ligue1,2005
AS Nancy,38,12,12,14,35,37,-2,ligue1,2005
Saint-Étienne,38,11,14,13,29,39,-10,ligue1,2005
FC Nantes,38,11,12,15,37,41,-4,ligue1,2005
FC Sochaux,38,11,11,16,34,47,-13,ligue1,2005
Toulouse,38,10,11,17,36,47,-11,ligue1,2005
Troyes,38,9,12,17,37,47,-10,ligue1,2005
AC Ajaccio,38,8,9,21,27,53,-26,ligue1,2005
R. Strasbourg,38,5,14,19,33,56,-23,ligue1,2005
FC Metz,38,6,11,21,26,59,-33,ligue1,2005
Olympique Lyon,38,24,9,5,64,27,37,ligue1,2006
Marseille,38,19,7,12,53,38,15,ligue1,2006
Toulouse,38,17,7,14,47,43,4,ligue1,2006
Stade Rennais,38,14,15,9,38,30,8,ligue1,2006
Lens,38,15,12,11,47,41,6,ligue1,2006
G. Bordeaux,38,16,9,13,39,35,4,ligue1,2006
FC Sochaux,38,15,12,11,46,48,-2,ligue1,2006
AJ Auxerre,38,13,15,10,41,41,0,ligue1,2006
Monaco,38,13,12,13,45,38,7,ligue1,2006
LOSC Lille,38,13,11,14,45,43,2,ligue1,2006
Saint-Étienne,38,14,7,17,52,50,2,ligue1,2006
Le Mans UC 72,38,11,16,11,45,46,-1,ligue1,2006
AS Nancy,38,13,10,15,37,44,-7,ligue1,2006
FC Lorient,38,12,13,13,33,40,-7,ligue1,2006
Paris SG,38,12,12,14,42,42,0,ligue1,2006
OGC Nice,38,9,16,13,34,40,-6,ligue1,2006
Valenciennes FC,38,11,10,17,36,48,-12,ligue1,2006
Troyes,38,9,12,17,39,54,-15,ligue1,2006
CS Sedan,38,7,14,17,46,58,-12,ligue1,2006
FC Nantes,38,7,13,18,29,52,-23,ligue1,2006
Olympique Lyon,38,24,7,7,74,37,37,ligue1,2007
G. Bordeaux,38,22,9,7,65,38,27,ligue1,2007
Marseille,38,17,11,10,58,45,13,ligue1,2007
AS Nancy,38,15,15,8,44,30,14,ligue1,2007
Saint-Étienne,38,16,10,12,47,34,13,ligue1,2007
Stade Rennais,38,16,10,12,47,44,3,ligue1,2007
LOSC Lille,38,13,18,7,45,32,13,ligue1,2007
OGC Nice,38,13,16,9,35,30,5,ligue1,2007
Le Mans UC 72,38,14,11,13,46,49,-3,ligue1,2007
FC Lorient,38,12,16,10,32,35,-3,ligue1,2007
SM Caen,38,13,12,13,48,53,-5,ligue1,2007
Monaco,38,13,8,17,40,48,-8,ligue1,2007
Valenciennes FC,38,12,9,17,42,40,2,ligue1,2007
FC Sochaux,38,10,14,14,34,43,-9,ligue1,2007
AJ Auxerre,38,12,8,18,33,52,-19,ligue1,2007
Paris SG,38,10,13,15,37,45,-8,ligue1,2007
Toulouse,38,9,15,14,36,42,-6,ligue1,2007
Lens,38,9,13,16,43,52,-9,ligue1,2007
R. Strasbourg,38,9,8,21,34,55,-21,ligue1,2007
FC Metz,38,5,9,24,28,64,-36,ligue1,2007
G. Bordeaux,38,24,8,6,64,34,30,ligue1,2008
Marseille,38,22,11,5,67,35,32,ligue1,2008
Olympique Lyon,38,20,11,7,52,29,23,ligue1,2008
Toulouse,38,16,16,6,45,27,18,ligue1,2008
LOSC Lille,38,17,13,8,51,39,12,ligue1,2008
Paris SG,38,19,7,12,49,38,11,ligue1,2008
Stade Rennais,38,15,16,7,42,34,8,ligue1,2008
AJ Auxerre,38,16,7,15,35,35,0,ligue1,2008
OGC Nice,38,13,11,14,40,41,-1,ligue1,2008
FC Lorient,38,10,15,13,47,47,0,ligue1,2008
Monaco,38,11,12,15,41,45,-4,ligue1,2008
Valenciennes FC,38,10,14,14,35,42,-7,ligue1,2008
Grenoble,38,10,14,14,24,37,-13,ligue1,2008
FC Sochaux,38,10,12,16,40,48,-8,ligue1,2008
AS Nancy,38,10,12,16,38,47,-9,ligue1,2008
Le Mans UC 72,38,10,10,18,43,54,-11,ligue1,2008
Saint-Étienne,38,11,7,20,40,56,-16,ligue1,2008
SM Caen,38,8,13,17,42,49,-7,ligue1,2008
FC Nantes,38,9,10,19,33,54,-21,ligue1,2008
Le Havre AC,38,7,5,26,30,67,-37,ligue1,2008
Marseille,38,23,9,6,69,36,33,ligue1,2009
Olympique Lyon,38,20,12,6,64,38,26,ligue1,2009
AJ Auxerre,38,20,11,7,42,29,13,ligue1,2009
LOSC Lille,38,21,7,10,72,40,32,ligue1,2009
Montpellier,38,20,9,9,50,40,10,ligue1,2009
G. Bordeaux,38,19,7,12,58,40,18,ligue1,2009
FC Lorient,38,16,10,12,54,42,12,ligue1,2009
Monaco,38,15,10,13,39,45,-6,ligue1,2009
Stade Rennais,38,14,11,13,52,41,11,ligue1,2009
Valenciennes FC,38,14,10,14,50,50,0,ligue1,2009
Lens,38,12,12,14,40,44,-4,ligue1,2009
AS Nancy,38,13,9,16,46,53,-7,ligue1,2009
Paris SG,38,12,11,15,50,46,4,ligue1,2009
Toulouse,38,12,11,15,36,36,0,ligue1,2009
OGC Nice,38,11,11,16,41,57,-16,ligue1,2009
FC Sochaux,38,11,8,19,28,52,-24,ligue1,2009
Saint-Étienne,38,10,10,18,27,45,-18,ligue1,2009
Le Mans UC 72,38,8,8,22,36,59,-23,ligue1,2009
US Boulogne,38,7,10,21,31,62,-31,ligue1,2009
Grenoble,38,5,8,25,31,61,-30,ligue1,2009
LOSC Lille,38,21,13,4,68,36,32,ligue1,2010
Marseille,38,18,14,6,62,39,23,ligue1,2010
Olympique Lyon,38,17,13,8,61,40,21,ligue1,2010
Paris SG,38,15,15,8,56,41,15,ligue1,2010
FC Sochaux,38,17,7,14,60,43,17,ligue1,2010
Stade Rennais,38,15,11,12,38,35,3,ligue1,2010
G. Bordeaux,38,12,15,11,43,42,1,ligue1,2010
Toulouse,38,14,8,16,38,36,2,ligue1,2010
AJ Auxerre,38,10,19,9,45,41,4,ligue1,2010
Saint-Étienne,38,12,13,13,46,47,-1,ligue1,2010
FC Lorient,38,12,13,13,46,48,-2,ligue1,2010
Valenciennes FC,38,10,18,10,45,41,4,ligue1,2010
AS Nancy,38,13,9,16,43,48,-5,ligue1,2010
Montpellier,38,12,11,15,32,43,-11,ligue1,2010
SM Caen,38,11,13,14,46,51,-5,ligue1,2010
Stade Brestois,38,11,13,14,36,43,-7,ligue1,2010
OGC Nice,38,11,13,14,33,48,-15,ligue1,2010
Monaco,38,9,17,12,36,40,-4,ligue1,2010
Lens,38,7,14,17,35,58,-23,ligue1,2010
AC Arles-Avignon,38,3,11,24,21,70,-49,ligue1,2010
Montpellier,38,25,7,6,68,34,34,ligue1,2011
Paris SG,38,23,10,5,75,41,34,ligue1,2011
LOSC Lille,38,21,11,6,72,39,33,ligue1,2011
Olympique Lyon,38,19,7,12,64,51,13,ligue1,2011
G. Bordeaux,38,16,13,9,53,41,12,ligue1,2011
Stade Rennais,38,17,9,12,53,44,9,ligue1,2011
Saint-Étienne,38,16,9,13,49,45,4,ligue1,2011
Toulouse,38,15,11,12,37,34,3,ligue1,2011
Évian,38,13,11,14,54,55,-1,ligue1,2011
Marseille,38,12,12,14,45,41,4,ligue1,2011
AS Nancy,38,11,12,15,38,48,-10,ligue1,2011
Valenciennes FC,38,12,7,19,40,50,-10,ligue1,2011
OGC Nice,38,10,12,16,39,46,-7,ligue1,2011
FC Sochaux,38,11,9,18,40,60,-20,ligue1,2011
Stade Brestois,38,8,17,13,31,38,-7,ligue1,2011
AC Ajaccio,38,9,14,15,40,61,-21,ligue1,2011
FC Lorient,38,9,12,17,35,49,-14,ligue1,2011
SM Caen,38,9,11,18,39,59,-20,ligue1,2011
Dijon,38,9,9,20,38,63,-25,ligue1,2011
AJ Auxerre,38,7,13,18,46,57,-11,ligue1,2011
Paris SG,38,25,8,5,69,23,46,ligue1,2012
Marseille,38,21,8,9,42,36,6,ligue1,2012
Olympique Lyon,38,19,10,9,61,38,23,ligue1,2012
OGC Nice,38,18,10,10,57,46,11,ligue1,2012
Saint-Étienne,38,16,15,7,60,32,28,ligue1,2012
LOSC Lille,38,16,14,8,59,40,19,ligue1,2012
G. Bordeaux,38,13,16,9,40,34,6,ligue1,2012
FC Lorient,38,14,11,13,57,58,-1,ligue1,2012
Montpellier,38,15,7,16,54,51,3,ligue1,2012
Toulouse,38,13,12,13,49,47,2,ligue1,2012
Valenciennes FC,38,12,12,14,49,53,-4,ligue1,2012
SC Bastia,38,13,8,17,50,66,-16,ligue1,2012
Stade Rennais,38,13,7,18,48,59,-11,ligue1,2012
Stade Reims,38,10,13,15,33,42,-9,ligue1,2012
FC Sochaux,38,10,11,17,41,57,-16,ligue1,2012
Évian,38,10,10,18,46,53,-7,ligue1,2012
AC Ajaccio,38,9,15,14,39,51,-12,ligue1,2012
AS Nancy,38,9,11,18,38,58,-20,ligue1,2012
Troyes,38,8,13,17,43,61,-18,ligue1,2012
Stade Brestois,38,8,5,25,32,62,-30,ligue1,2012
Paris SG,38,27,8,3,84,23,61,ligue1,2013
Monaco,38,23,11,4,63,31,32,ligue1,2013
LOSC Lille,38,20,11,7,46,26,20,ligue1,2013
Saint-Étienne,38,20,9,9,56,34,22,ligue1,2013
Olympique Lyon,38,17,10,11,56,44,12,ligue1,2013
Marseille,38,16,12,10,53,40,13,ligue1,2013
G. Bordeaux,38,13,14,11,49,43,6,ligue1,2013
FC Lorient,38,13,10,15,48,53,-5,ligue1,2013
Toulouse,38,12,13,13,46,53,-7,ligue1,2013
SC Bastia,38,12,11,15,42,56,-14,ligue1,2013
Stade Reims,38,12,12,14,44,52,-8,ligue1,2013
Stade Rennais,38,11,13,14,47,45,2,ligue1,2013
FC Nantes,38,12,11,15,38,43,-5,ligue1,2013
Évian,38,11,11,16,39,51,-12,ligue1,2013
Montpellier,38,8,18,12,45,53,-8,ligue1,2013
Guingamp,38,11,9,18,34,42,-8,ligue1,2013
OGC Nice,38,12,6,20,30,44,-14,ligue1,2013
FC Sochaux,38,10,10,18,37,61,-24,ligue1,2013
Valenciennes FC,38,7,8,23,37,65,-28,ligue1,2013
AC Ajaccio,38,4,11,23,37,72,-35,ligue1,2013
Paris SG,38,24,11,3,83,36,47,ligue1,2014
Olympique Lyon,38,22,9,7,72,33,39,ligue1,2014
Monaco,38,20,11,7,51,26,25,ligue1,2014
Marseille,38,21,6,11,76,42,34,ligue1,2014
Saint-Étienne,38,19,12,7,51,30,21,ligue1,2014
G. Bordeaux,38,17,12,9,47,44,3,ligue1,2014
Montpellier,38,16,8,14,46,39,7,ligue1,2014
LOSC Lille,38,16,8,14,43,42,1,ligue1,2014
Stade Rennais,38,13,11,14,35,42,-7,ligue1,2014
Guingamp,38,15,4,19,41,55,-14,ligue1,2014
OGC Nice,38,13,9,16,44,53,-9,ligue1,2014
SC Bastia,38,12,11,15,37,46,-9,ligue1,2014
SM Caen,38,12,10,16,54,55,-1,ligue1,2014
FC Nantes,38,11,12,15,29,40,-11,ligue1,2014
Stade Reims,38,12,8,18,47,66,-19,ligue1,2014
FC Lorient,38,12,7,19,44,50,-6,ligue1,2014
Toulouse,38,12,6,20,43,64,-21,ligue1,2014
Évian,38,11,4,23,41,62,-21,ligue1,2014
FC Metz,38,7,9,22,31,61,-30,ligue1,2014
Lens,38,7,8,23,32,61,-29,ligue1,2014
Paris SG,38,30,6,2,102,19,83,ligue1,2015
Olympique Lyon,38,19,8,11,67,43,24,ligue1,2015
Monaco,38,17,14,7,57,50,7,ligue1,2015
OGC Nice,38,18,9,11,58,41,17,ligue1,2015
LOSC Lille,38,15,15,8,39,27,12,ligue1,2015
Saint-Étienne,38,17,7,14,42,37,5,ligue1,2015
SM Caen,38,16,6,16,39,52,-13,ligue1,2015
Stade Rennais,38,13,13,12,52,54,-2,ligue1,2015
Angers SCO,38,13,11,14,40,38,2,ligue1,2015
SC Bastia,38,14,8,16,36,42,-6,ligue1,2015
G. Bordeaux,38,12,14,12,50,57,-7,ligue1,2015
Montpellier,38,14,7,17,49,47,2,ligue1,2015
Marseille,38,10,18,10,48,42,6,ligue1,2015
FC Nantes,38,12,12,14,33,44,-11,ligue1,2015
FC Lorient,38,11,13,14,47,58,-11,ligue1,2015
Guingamp,38,11,11,16,47,56,-9,ligue1,2015
Toulouse,38,9,13,16,45,55,-10,ligue1,2015
Stade Reims,38,10,9,19,44,57,-13,ligue1,2015
G. Ajaccio,38,8,13,17,37,58,-21,ligue1,2015
Troyes,38,3,9,26,28,83,-55,ligue1,2015
Monaco,38,30,5,3,107,31,76,ligue1,2016
Paris SG,38,27,6,5,83,27,56,ligue1,2016
OGC Nice,38,22,12,4,63,36,27,ligue1,2016
Olympique Lyon,38,20,5,13,77,48,29,ligue1,2016
Marseille,38,17,11,10,57,41,16,ligue1,2016
G. Bordeaux,38,15,14,9,53,43,10,ligue1,2016
FC Nantes,38,14,9,15,40,54,-14,ligue1,2016
Saint-Étienne,38,12,14,12,41,42,-1,ligue1,2016
Stade Rennais,38,12,14,12,36,42,-6,ligue1,2016
Guingamp,38,14,8,16,46,53,-7,ligue1,2016
LOSC Lille,38,13,7,18,40,47,-7,ligue1,2016
Angers SCO,38,13,7,18,40,49,-9,ligue1,2016
Toulouse,38,10,14,14,37,41,-4,ligue1,2016
FC Metz,38,11,10,17,39,72,-33,ligue1,2016
Montpellier,38,10,9,19,48,66,-18,ligue1,2016
Dijon,38,8,13,17,46,58,-12,ligue1,2016
SM Caen,38,10,7,21,36,65,-29,ligue1,2016
FC Lorient,38,10,6,22,44,70,-26,ligue1,2016
AS Nancy,38,9,8,21,29,52,-23,ligue1,2016
SC Bastia,38,8,11,19,29,54,-25,ligue1,2016
Paris SG,38,29,6,3,108,29,79,ligue1,2017
Monaco,38,24,8,6,85,45,40,ligue1,2017
Olympique Lyon,38,23,9,6,87,43,44,ligue1,2017
Marseille,38,22,11,5,80,47,33,ligue1,2017
Stade Rennais,38,16,10,12,50,44,6,ligue1,2017
G. Bordeaux,38,16,7,15,53,48,5,ligue1,2017
Saint-Étienne,38,15,10,13,47,50,-3,ligue1,2017
OGC Nice,38,15,9,14,53,52,1,ligue1,2017
FC Nantes,38,14,10,14,36,41,-5,ligue1,2017
Montpellier,38,11,18,9,36,33,3,ligue1,2017
Dijon,38,13,9,16,55,73,-18,ligue1,2017
Guingamp,38,12,11,15,48,59,-11,ligue1,2017
Amiens SC,38,12,9,17,37,42,-5,ligue1,2017
Angers SCO,38,9,14,15,42,52,-10,ligue1,2017
R. Strasbourg,38,9,11,18,44,67,-23,ligue1,2017
SM Caen,38,10,8,20,27,52,-25,ligue1,2017
LOSC Lille,38,10,8,20,41,67,-26,ligue1,2017
Toulouse,38,9,10,19,38,54,-16,ligue1,2017
Troyes,38,9,6,23,32,59,-27,ligue1,2017
FC Metz,38,6,8,24,34,76,-42,ligue1,2017
Paris SG,38,29,4,5,105,35,70,ligue1,2018
LOSC Lille,38,22,9,7,68,33,35,ligue1,2018
Olympique Lyon,38,21,9,8,70,47,23,ligue1,2018
Saint-Étienne,38,19,9,10,59,41,18,ligue1,2018
Marseille,38,18,7,13,60,52,8,ligue1,2018
Montpellier,38,15,14,9,53,42,11,ligue1,2018
OGC Nice,38,15,11,12,30,35,-5,ligue1,2018
Stade Reims,38,13,16,9,39,42,-3,ligue1,2018
Nîmes Olympique,38,15,8,15,57,58,-1,ligue1,2018
Stade Rennais,38,13,13,12,55,52,3,ligue1,2018
R. Strasbourg,38,11,16,11,58,48,10,ligue1,2018
FC Nantes,38,13,9,16,48,48,0,ligue1,2018
Angers SCO,38,10,16,12,44,49,-5,ligue1,2018
G. Bordeaux,38,10,11,17,34,42,-8,ligue1,2018
Amiens SC,38,9,11,18,31,52,-21,ligue1,2018
Toulouse,38,8,14,16,35,57,-22,ligue1,2018
Monaco,38,8,12,18,38,57,-19,ligue1,2018
Dijon,38,9,7,22,31,60,-29,ligue1,2018
SM Caen,38,7,12,19,29,54,-25,ligue1,2018
Guingamp,38,5,12,21,28,68,-40,ligue1,2018
Paris SG,27,22,2,3,75,24,51,ligue1,2019
Marseille,28,16,8,4,41,29,12,ligue1,2019
Stade Rennais,28,15,5,8,38,24,14,ligue1,2019
LOSC Lille,28,15,4,9,35,27,8,ligue1,2019
Stade Reims,28,10,11,7,26,21,5,ligue1,2019
OGC Nice,28,11,8,9,41,38,3,ligue1,2019
Olympique Lyon,28,11,7,10,42,27,15,ligue1,2019
Montpellier,28,11,7,10,35,34,1,ligue1,2019
Monaco,28,11,7,10,44,44,0,ligue1,2019
R. Strasbourg,27,11,5,11,32,32,0,ligue1,2019
Angers SCO,28,11,6,11,28,33,-5,ligue1,2019
G. Bordeaux,28,9,10,9,40,34,6,ligue1,2019
FC Nantes,28,11,4,13,28,31,-3,ligue1,2019
Stade Brestois,28,8,10,10,34,37,-3,ligue1,2019
FC Metz,28,8,10,10,27,35,-8,ligue1,2019
Dijon,28,7,9,12,27,37,-10,ligue1,2019
Saint-Étienne,28,8,6,14,29,45,-16,ligue1,2019
Nîmes Olympique,28,7,6,15,29,44,-15,ligue1,2019
Amiens SC,28,4,11,13,31,50,-19,ligue1,2019
Toulouse,28,3,4,21,22,58,-36,ligue1,2019
LOSC Lille,38,24,11,3,64,23,41,ligue1,2020
Paris SG,38,26,4,8,86,28,58,ligue1,2020
Monaco,38,24,6,8,76,42,34,ligue1,2020
Olympique Lyon,38,22,10,6,81,43,38,ligue1,2020
Marseille,38,16,12,10,54,47,7,ligue1,2020
Stade Rennais,38,16,10,12,52,40,12,ligue1,2020
Lens,38,15,12,11,55,54,1,ligue1,2020
Montpellier,38,14,12,12,60,62,-2,ligue1,2020
OGC Nice,38,15,7,16,50,53,-3,ligue1,2020
FC Metz,38,12,11,15,44,48,-4,ligue1,2020
Saint-Étienne,38,12,10,16,42,54,-12,ligue1,2020
G. Bordeaux,38,13,6,19,42,56,-14,ligue1,2020
Angers SCO,38,12,8,18,40,58,-18,ligue1,2020
Stade Reims,38,9,15,14,42,50,-8,ligue1,2020
R. Strasbourg,38,11,9,18,49,58,-9,ligue1,2020
FC Lorient,38,11,9,18,50,68,-18,ligue1,2020
Stade Brestois,38,11,8,19,50,66,-16,ligue1,2020
FC Nantes,38,9,13,16,47,55,-8,ligue1,2020
Nîmes Olympique,38,9,8,21,40,71,-31,ligue1,2020
Dijon,38,4,9,25,25,73,-48,ligue1,2020
Paris SG,38,26,8,4,90,36,54,ligue1,2021
Marseille,38,21,8,9,63,38,25,ligue1,2021
Monaco,38,20,9,9,65,40,25,ligue1,2021
Stade Rennais,38,20,6,12,82,40,42,ligue1,2021
OGC Nice,38,20,7,11,52,36,16,ligue1,2021
R. Strasbourg,38,17,12,9,60,43,17,ligue1,2021
Lens,38,17,11,10,62,48,14,ligue1,2021
Olympique Lyon,38,17,11,10,66,51,15,ligue1,2021
FC Nantes,38,15,10,13,55,48,7,ligue1,2021
LOSC Lille,38,14,13,11,48,48,0,ligue1,2021
Stade Brestois,38,13,9,16,49,57,-8,ligue1,2021
Stade Reims,38,11,13,14,43,44,-1,ligue1,2021
Montpellier,38,12,7,19,49,61,-12,ligue1,2021
Angers SCO,38,10,11,17,44,55,-11,ligue1,2021
Troyes,38,9,11,18,37,53,-16,ligue1,2021
FC Lorient,38,8,12,18,35,63,-28,ligue1,2021
Clermont Foot,38,9,9,20,38,69,-31,ligue1,2021
Saint-Étienne,38,7,11,20,42,77,-35,ligue1,2021
FC Metz,38,6,13,19,35,69,-34,ligue1,2021
G. Bordeaux,38,6,13,19,52,91,-39,ligue1,2021
Paris SG,38,27,4,7,89,40,49,ligue1,2022
Lens,38,25,9,4,68,29,39,ligue1,2022
Marseille,38,22,7,9,67,40,27,ligue1,2022
Stade Rennais,38,21,5,12,69,39,30,ligue1,2022
LOSC Lille,38,19,10,9,65,44,21,ligue1,2022
Monaco,38,19,8,11,70,58,12,ligue1,2022
Olympique Lyon,38,18,8,12,65,47,18,ligue1,2022
Clermont Foot,38,17,8,13,45,49,-4,ligue1,2022
OGC Nice,38,15,13,10,48,37,11,ligue1,2022
FC Lorient,38,15,10,13,52,53,-1,ligue1,2022
Stade Reims,38,12,15,11,45,45,0,ligue1,2022
Montpellier,38,15,5,18,65,62,3,ligue1,2022
Toulouse,38,13,9,16,51,57,-6,ligue1,2022
Stade Brestois,38,11,11,16,44,54,-10,ligue1,2022
R. Strasbourg,38,9,13,16,51,59,-8,ligue1,2022
FC Nantes,38,7,15,16,37,55,-18,ligue1,2022
AJ Auxerre,38,8,11,19,35,63,-28,ligue1,2022
AC Ajaccio,38,7,5,26,23,74,-51,ligue1,2022
Troyes,38,4,12,22,45,81,-36,ligue1,2022
Angers SCO,38,4,6,28,33,81,-48,ligue1,2022
Paris SG,34,22,10,2,81,33,48,ligue1,2023
Monaco,34,20,7,7,68,42,26,ligue1,2023
Stade Brestois,34,17,10,7,53,34,19,ligue1,2023
LOSC Lille,34,16,11,7,52,34,18,ligue1,2023
OGC Nice,34,15,10,9,40,29,11,ligue1,2023
Olympique Lyon,34,16,5,13,49,55,-6,ligue1,2023
Lens,34,14,9,11,45,37,8,ligue1,2023
Marseille,34,13,11,10,52,41,11,ligue1,2023
Stade Reims,34,13,8,13,42,47,-5,ligue1,2023
Stade Rennais,34,12,10,12,53,46,7,ligue1,2023
Toulouse,34,11,10,13,42,46,-4,ligue1,2023
Montpellier,34,10,12,12,43,48,-5,ligue1,2023
R. Strasbourg,34,10,9,15,38,50,-12,ligue1,2023
FC Nantes,34,9,6,19,30,55,-25,ligue1,2023
Le Havre AC,34,7,11,16,34,45,-11,ligue1,2023
FC Metz,34,8,5,21,35,58,-23,ligue1,2023
FC Lorient,34,7,8,19,43,66,-23,ligue1,2023
Clermont Foot,34,5,10,19,26,60,-34,ligue1,2023
Paris SG,28,23,5,0,80,26,54,ligue1,2024
Marseille,28,16,4,8,57,38,19,ligue1,2024
Monaco,28,15,5,8,54,35,19,ligue1,2024
R. Strasbourg,28,14,7,7,46,35,11,ligue1,2024
Olympique Lyon,28,14,6,8,54,38,16,ligue1,2024
OGC Nice,28,13,8,7,52,35,17,ligue1,2024
LOSC Lille,28,13,8,7,42,30,12,ligue1,2024
Stade Brestois,28,13,4,11,44,43,1,ligue1,2024
Lens,29,12,6,11,32,32,0,ligue1,2024
AJ Auxerre,28,10,8,10,39,39,0,ligue1,2024
Toulouse,28,9,7,12,37,36,1,ligue1,2024
Stade Rennais,28,10,2,16,38,38,0,ligue1,2024
FC Nantes,28,7,9,12,33,47,-14,ligue1,2024
Stade Reims,29,7,8,14,31,42,-11,ligue1,2024
Angers SCO,28,7,6,15,26,46,-20,ligue1,2024
Le Havre AC,28,8,3,17,31,57,-26,ligue1,2024
Saint-Étienne,28,6,5,17,28,64,-36,ligue1,2024
Montpellier,28,4,3,21,21,64,-43,ligue1,2024
